84 84 84 84 84 84 84 84 84 84 84 84 84 84 84 84 84 84 84 84 84 84 84 84 84 84 84 84 84 84 84 84 84
84 16 16 16 16 16 36 84 84 84 84 84 84 84 84 84 84 84 84 84 84 84 84 84 84 84 38 16 16 16 16 16 84
84 16 0 0 0 16 36 84 84 84 84 84 84 84 84 84 84 84 84 84 84 84 84 84 84 84 38 16 0 0 0 16 84
84 16 0 60 41 41 41 41 41 41 41 41 41 41 41 41 41 41 41 41 41 41 41 41 41 41 41 41 41 60 0 16 84
84 16 0 40 0 16 36 84 84 84 84 84 84 84 84 84 40 84 84 84 84 84 84 84 84 84 38 16 0 40 0 16 84
84 16 16 40 16 16 36 84 84 84 84 84 84 84 84 84 40 84 84 84 84 84 84 84 84 84 38 16 16 40 16 16 84
84 39 39 40 39 39 12 84 84 84 84 84 84 84 84 84 40 84 84 84 84 84 84 84 84 84 15 39 39 40 39 39 84
84 84 84 40 84 84 84 84 84 84 84 84 84 84 84 84 40 84 84 84 84 84 84 84 84 84 84 84 84 40 84 84 84
84 84 84 40 84 84 84 84 84 84 84 84 84 84 84 84 40 84 84 84 84 84 84 84 84 84 84 84 84 40 84 84 84
84 84 84 40 84 84 84 84 84 84 84 84 84 84 84 84 40 84 84 84 84 84 84 84 84 84 84 84 84 40 84 84 84
84 84 84 40 84 84 84 84 84 84 84 84 84 84 84 84 40 84 84 84 84 84 84 84 84 84 84 84 84 40 84 84 84
84 84 84 40 84 84 84 84 84 84 84 84 84 84 84 84 40 84 84 84 84 84 84 84 84 84 84 84 84 40 84 84 84
84 84 84 40 84 84 84 84 84 84 84 84 84 84 84 84 40 84 84 84 84 84 84 84 84 84 84 84 84 40 84 84 84
84 84 84 40 84 84 84 84 84 84 84 84 84 84 84 84 40 84 84 84 84 84 84 84 84 84 84 84 84 40 84 84 84
84 84 84 40 84 84 84 84 84 84 84 84 84 84 84 84 40 84 84 84 84 84 84 84 84 84 84 84 84 40 84 84 84
84 84 84 40 84 84 84 84 84 84 84 84 84 84 84 84 40 84 84 84 84 84 84 84 84 84 84 84 84 40 84 84 84
84 84 84 40 41 41 41 41 41 41 41 41 41 41 41 41 41 41 41 41 41 41 41 41 41 41 41 41 41 40 84 84 84
84 84 84 40 84 84 84 84 84 84 84 84 84 84 84 84 40 84 84 84 84 84 84 84 84 84 84 84 84 40 84 84 84
84 84 84 40 84 84 84 84 84 84 84 84 84 84 84 84 40 84 84 84 84 84 84 84 84 84 84 84 84 40 84 84 84
84 84 84 40 84 84 84 84 84 84 84 84 84 84 84 84 40 84 84 84 84 84 84 84 84 84 84 84 84 40 84 84 84
84 84 84 40 84 84 84 84 84 84 84 84 84 84 84 84 40 84 84 84 84 84 84 84 84 84 84 84 84 40 84 84 84
84 84 84 40 84 84 84 84 84 84 84 84 84 84 84 84 40 84 84 84 84 84 84 84 84 84 84 84 84 40 84 84 84
84 84 84 40 84 84 84 84 84 84 84 84 84 84 84 84 40 84 84 84 84 84 84 84 84 84 84 84 84 40 84 84 84
84 84 84 40 84 84 84 84 84 84 84 84 84 84 84 84 40 84 84 84 84 84 84 84 84 84 84 84 84 40 84 84 84
84 84 84 40 84 84 84 84 84 84 84 84 84 84 84 84 40 84 84 84 84 84 84 84 84 84 84 84 84 40 84 84 84
84 84 84 40 84 84 84 84 84 84 84 84 84 84 84 84 40 84 84 84 84 84 84 84 84 84 84 84 84 40 84 84 84
84 37 37 40 37 37 13 84 84 84 84 84 84 84 84 84 40 84 84 84 84 84 84 84 84 84 14 37 37 40 37 37 84
84 16 16 40 16 16 36 84 84 84 84 84 84 84 84 84 40 84 84 84 84 84 84 84 84 84 38 16 16 40 16 16 84
84 16 0 40 0 16 36 84 84 84 84 84 84 84 84 84 40 84 84 84 84 84 84 84 84 84 38 16 0 40 0 16 84
84 16 0 60 41 41 41 41 41 41 41 41 41 41 41 41 41 41 41 41 41 41 41 41 41 41 41 41 41 60 0 16 84
84 16 0 0 0 16 36 84 84 84 84 84 84 84 84 84 84 84 84 84 84 84 84 84 84 84 38 16 0 0 0 16 84
84 16 16 16 16 16 36 84 84 84 84 84 84 84 84 84 84 84 84 84 84 84 84 84 84 84 38 16 16 16 16 16 84
84 84 84 84 84 84 84 84 84 84 84 84 84 84 84 84 84 84 84 84 84 84 84 84 84 84 84 84 84 84 84 84 84