36 12 12 72 76 72 72 72 72 72 72 72 72 72 72 72 72 72 72 72
12 12 12 72 72 72 72 72 72 72 72 72 72 72 72 72 72 72 72 72
56 56 56 56 56 56 56 56 56 56 56 56 56 56 56 56 72 16 16 16
72 72 56 72 72 72 72 72 72 72 76 72 72 72 72 72 72 16 39 15
72 72 72 72 72 72 72 72 72 72 72 72 72 72 72 72 72 16 15 15
72 72 56 56 56 56 56 56 56 56 56 56 56 72 16 16 16 16 0 0
72 72 56 72 72 56 72 72 76 72 72 72 72 72 16 15 39 16 0 44
72 72 56 72 72 72 72 72 72 72 72 72 72 72 16 0 0 16 0 0
72 72 56 72 72 16 16 16 16 16 16 16 16 16 16 0 44 16 0 0
72 72 56 72 72 16 72 72 72 72 80 16 0 0 0 0 0 16 0 0
72 72 56 72 72 72 72 72 56 72 81 0 0 0 56 0 0 16 0 0
72 72 56 76 72 56 56 56 56 56 56 56 56 56 56 0 0 16 0 0
72 72 56 72 72 56 0 0 0 0 0 0 0 0 0 0 0 16 0 0
76 72 56 37 13 56 0 0 0 0 0 44 0 0 16 0 0 16 0 0
72 72 56 56 56 56 0 16 16 16 16 16 16 16 16 16 16 16 0 0
13 13 56 0 0 0 0 0 0 0 0 0 0 0 0 0 0 0 0 0
13 37 56 0 0 0 0 0 0 44 0 0 0 0 0 0 0 16 0 0
56 56 56 0 16 16 16 16 16 16 16 16 16 16 16 16 16 16 16 16
0 0 0 0 0 0 0 0 0 0 0 0 0 0 0 0 0 14 14 14
0 0 0 0 0 0 0 0 0 0 0 0 0 0 0 44 0 14 14 38