36 12 12 12 12 12 12 12 12 12 12 12 12 12 12 12 12 12 12 12 12 12 12 12 12 16 12 12 12 12
16 16 16 16 16 16 16 16 16 16 16 16 16 16 16 12 12 12 12 12 56 12 12 12 12 16 12 12 12 12
36 12 12 12 12 12 12 12 12 12 12 12 12 12 12 12 12 12 12 12 56 12 12 12 12 16 12 12 12 12
56 56 56 56 56 56 56 56 56 56 56 56 56 12 12 12 12 12 12 12 56 12 12 12 12 16 12 12 12 12
36 12 12 12 12 12 12 12 12 12 12 12 12 12 12 12 12 12 12 12 56 12 12 12 12 12 12 12 12 12
16 16 16 16 16 16 16 16 16 16 16 16 16 16 16 12 12 12 12 12 56 12 12 12 12 12 12 12 12 12
36 12 12 12 12 12 12 12 12 12 12 12 12 12 12 12 12 12 12 12 12 12 12 12 12 12 12 12 12 12
56 56 56 56 56 56 56 56 56 56 56 56 56 12 12 12 12 12 12 12 12 12 12 12 12 56 12 12 12 12
36 12 12 12 12 12 12 12 12 12 12 12 12 12 12 12 12 12 12 12 12 12 12 12 12 56 12 12 12 12
16 16 16 16 16 16 16 16 16 16 16 16 16 16 16 12 12 12 12 12 16 12 12 12 12 56 12 12 12 12
36 12 12 12 12 12 12 12 12 12 12 12 12 12 12 12 12 12 12 12 16 12 12 12 12 56 12 12 12 12
56 56 56 56 56 56 56 56 56 56 56 56 56 12 12 12 12 12 12 12 16 12 12 12 12 56 12 12 12 12
36 12 12 12 12 12 12 12 12 12 12 12 12 12 12 12 12 12 12 12 16 12 12 12 12 12 12 12 12 12
16 16 16 16 16 16 16 16 16 16 16 16 16 16 16 12 12 12 12 12 16 12 12 12 12 12 12 12 12 12
36 12 12 12 12 12 12 12 12 12 12 12 12 12 12 12 12 12 12 12 12 12 12 12 12 12 12 12 12 12
56 56 56 56 56 56 56 56 56 56 56 56 56 12 12 12 12 12 12 12 12 12 12 12 12 16 12 12 12 12
36 12 12 12 12 12 12 12 12 12 12 12 12 12 12 12 12 12 12 12 12 12 12 12 12 16 12 12 12 12
16 16 16 16 16 16 16 16 16 16 16 16 16 16 16 12 12 12 12 12 56 12 12 12 12 16 12 12 12 12
36 12 12 12 12 12 12 12 12 12 12 12 12 12 12 12 12 12 12 12 56 12 12 12 12 16 12 12 12 12
56 56 56 56 56 56 56 56 56 56 56 56 56 12 12 12 12 12 12 12 56 12 12 12 12 16 12 12 12 12
36 12 12 12 12 12 12 12 12 12 12 12 12 12 12 12 12 12 12 12 56 12 12 12 12 12 12 12 12 12
16 16 16 16 16 16 16 16 16 16 16 16 16 16 16 12 12 12 12 12 56 12 12 12 12 12 12 12 12 12
36 12 12 12 12 12 12 12 12 12 12 12 12 12 12 12 12 12 12 12 12 12 12 12 12 12 12 12 12 12
56 56 56 56 56 56 56 56 56 56 56 56 56 12 12 12 12 12 12 12 12 12 12 12 12 56 12 12 12 12
36 12 12 12 12 12 12 12 12 12 12 12 12 12 12 12 12 12 12 12 12 12 12 12 12 56 12 12 12 12
16 16 16 16 16 16 16 16 16 16 16 16 16 16 16 12 12 12 12 12 16 12 12 12 12 56 12 12 12 12
36 12 12 12 12 12 12 12 12 12 12 12 12 12 12 12 12 12 12 12 16 12 12 12 12 56 12 12 12 12
56 56 56 56 56 56 56 56 56 56 56 56 56 12 12 12 12 12 12 12 16 12 12 12 12 56 12 12 12 12
36 12 12 12 12 12 12 12 12 12 12 12 12 12 12 12 12 12 12 12 16 12 12 12 12 12 12 12 12 12
16 16 16 16 16 16 16 16 16 16 16 16 16 16 16 12 12 12 12 12 16 12 12 12 12 12 12 12 12 12