48 48 48 48 48 48 48 48 48 48 48 48 48 48 48 48 48 48 48 48 48 48 48 48 48 48 48 40 52 52 52 52 52 52 52 52 52 52 52 52
48 16 16 16 16 16 16 16 16 16 16 16 16 48 48 48 48 48 48 48 48 48 48 48 48 48 48 40 52 52 52 52 52 52 52 52 52 52 52 52
48 16 15 15 15 16 39 39 39 39 39 39 16 16 16 16 16 48 48 48 48 48 48 48 48 48 48 40 52 52 52 52 52 52 52 52 52 52 52 52
48 16 15 60 15 16 15 15 15 15 15 15 84 84 84 84 16 48 48 48 48 48 48 48 48 48 48 40 52 52 52 52 52 52 52 52 52 52 52 52
48 16 15 40 15 15 15 15 15 15 15 15 16 16 16 84 16 48 48 48 48 48 48 48 48 48 48 40 52 52 52 52 52 52 52 52 52 52 48 52
48 16 16 40 16 16 16 16 16 16 16 16 16 48 16 84 16 48 48 48 48 48 48 48 48 48 48 40 52 52 52 52 52 52 52 52 52 52 52 52
48 48 48 40 48 48 48 48 48 48 48 48 48 48 16 84 16 48 48 48 48 48 48 48 48 48 48 40 52 52 52 52 52 52 52 52 52 52 52 52
48 48 48 40 48 48 48 48 48 48 48 48 16 16 16 84 16 48 48 48 48 48 48 48 48 48 48 40 52 52 52 52 52 52 52 52 52 52 52 52
48 48 48 40 48 48 48 48 48 48 48 48 16 84 84 84 16 48 48 48 48 48 48 48 48 48 48 40 52 52 52 52 52 52 16 16 16 16 16 52
48 48 56 40 56 48 48 48 48 48 48 48 16 84 16 16 16 48 48 48 48 48 48 48 48 48 56 40 56 52 52 52 52 52 16 14 14 14 16 52
41 41 41 40 41 41 41 41 41 41 41 41 41 41 41 41 41 41 41 41 41 41 41 41 41 41 41 41 41 41 41 41 41 41 41 41 63 14 16 52
24 24 56 40 56 16 16 16 16 16 16 16 16 84 16 24 24 24 24 24 24 24 24 24 24 24 56 40 56 52 52 52 52 52 16 14 14 14 16 52
24 24 24 40 24 16 84 84 84 84 84 84 84 84 16 24 24 24 24 24 24 24 24 24 24 24 24 40 52 52 52 52 52 52 16 14 16 16 16 52
24 24 24 40 24 16 84 16 16 16 16 16 16 84 16 24 24 24 24 24 24 24 24 24 24 24 24 40 52 52 52 52 52 52 16 14 14 38 16 52
24 24 24 40 24 16 84 16 24 24 24 24 16 84 16 24 24 24 24 24 24 24 24 24 24 24 24 40 52 52 52 52 52 52 16 14 14 38 16 52
24 24 24 40 16 16 84 16 16 24 24 24 16 84 16 24 24 24 24 24 24 24 24 24 24 24 24 40 52 52 52 52 52 52 16 14 14 38 16 52
24 24 24 40 16 36 12 12 16 24 24 24 16 84 16 24 24 24 24 24 24 24 24 24 24 24 24 40 52 52 52 52 52 52 16 14 14 38 16 52
24 24 24 40 16 36 12 12 16 24 24 24 16 84 16 24 24 24 24 24 24 24 24 24 24 24 24 40 52 52 52 52 52 52 16 14 14 38 16 52
24 24 24 40 16 36 12 12 16 24 24 24 16 84 16 24 24 24 24 24 24 24 24 24 24 24 24 40 52 52 52 52 52 52 16 14 14 38 16 52
24 24 24 40 16 36 12 12 16 24 24 24 16 84 16 24 24 24 24 24 24 24 24 24 24 24 24 40 52 52 52 52 52 52 16 16 84 16 16 52
24 24 24 40 16 36 12 12 16 24 24 24 16 84 16 24 24 24 24 24 24 24 24 24 24 24 24 40 52 52 52 52 52 52 52 16 84 16 52 52
24 24 24 40 16 36 12 12 16 24 24 24 16 84 16 24 24 24 24 24 24 24 24 24 24 24 24 40 52 52 52 52 52 52 52 16 84 16 52 52
24 24 24 40 16 16 16 12 16 24 24 24 16 84 16 24 24 24 24 24 24 24 24 24 24 24 24 40 52 52 52 52 52 52 52 16 84 16 52 52
24 24 24 40 16 12 12 12 16 24 24 24 16 84 16 24 24 24 24 24 24 24 24 24 24 24 56 40 56 52 48 48 48 48 48 16 84 16 48 48
24 24 24 40 16 12 61 41 41 41 41 41 41 41 41 41 41 41 41 41 41 41 41 41 41 41 41 40 41 41 41 41 41 41 41 41 41 41 41 41
24 24 24 40 16 12 12 12 16 48 48 48 16 84 16 48 48 48 48 48 48 48 48 48 48 48 56 40 56 48 48 48 48 48 48 16 84 16 48 48
24 24 24 40 16 16 16 16 16 48 48 48 16 84 16 16 16 16 16 16 16 16 16 16 16 16 16 40 16 16 16 16 16 16 16 16 84 16 48 48
24 24 24 40 48 48 48 48 48 48 48 48 16 84 84 84 84 84 84 84 84 84 84 84 84 84 84 40 84 84 84 84 84 84 84 84 84 16 48 48
24 24 24 40 48 48 48 48 48 48 48 48 16 84 16 16 16 16 16 16 16 16 16 16 16 16 16 40 16 16 16 16 16 16 16 16 16 16 48 48
24 24 24 40 48 48 48 48 16 16 16 16 16 84 16 48 48 48 48 48 48 48 48 48 48 48 48 40 48 48 48 48 48 48 48 48 48 48 48 48
24 24 24 40 48 48 48 48 16 84 84 84 84 84 16 48 48 48 48 48 48 48 48 48 48 48 48 40 48 48 48 48 48 48 48 48 48 48 48 48
24 24 24 40 48 48 48 48 16 84 16 16 16 16 16 48 48 48 48 48 48 48 48 48 48 48 48 40 48 48 48 48 48 48 48 48 48 48 48 48
24 24 24 40 48 48 48 48 16 84 16 48 48 48 48 48 48 48 48 48 48 48 48 48 48 48 48 40 48 48 48 48 48 48 48 48 48 48 48 48
24 24 24 40 48 48 48 48 16 84 16 48 48 48 48 48 48 48 16 16 16 16 16 16 16 16 16 40 16 16 48 48 48 48 48 48 48 48 48 48
24 24 24 40 48 48 48 48 16 84 16 16 16 16 16 16 16 16 16 13 13 13 13 13 13 13 13 40 13 16 48 48 48 48 48 48 48 48 48 48
24 24 24 40 48 48 48 48 16 84 84 84 84 84 84 84 84 84 84 13 13 13 13 13 13 16 13 62 13 16 48 48 48 48 48 48 48 48 48 48
24 24 24 40 48 48 48 48 16 16 16 16 16 16 16 16 16 16 16 37 37 37 37 37 37 16 13 13 13 16 48 48 48 48 48 48 48 48 48 48
24 24 24 40 48 48 48 48 48 48 48 48 48 48 48 48 48 48 16 16 16 16 16 16 16 16 16 16 16 16 48 48 48 48 48 48 48 48 48 48
24 24 24 40 48 48 48 48 48 48 48 48 48 48 48 48 48 48 48 48 48 48 48 48 48 48 48 48 48 48 48 48 48 48 48 48 48 48 48 48
24 24 24 40 48 48 48 48 48 48 48 48 48 48 48 48 48 48 48 48 48 48 48 48 48 48 48 48 48 48 48 48 48 48 48 48 48 48 48 48