0 0 0 0 0 0 0 0 0 0 0 0 0 0 0 0 0 0 0 0 0 64 84 84 84 84 84 84 84 84 84 84 84 84 84 84 66 0 0 0 0 0 40 0 0 0 0 0 0 0 0 0 0 0 0 0 0 0 0 0 0
0 0 0 0 0 0 0 0 0 0 0 0 0 0 0 0 0 0 0 0 0 64 84 84 84 84 84 84 84 84 84 84 84 84 84 84 66 0 0 0 0 0 40 0 0 0 0 0 0 0 0 0 0 0 0 0 0 0 0 0 0
0 0 16 16 16 16 16 16 16 16 16 16 16 16 16 16 16 16 16 0 0 64 84 84 84 84 84 84 84 84 84 84 84 84 84 84 66 0 0 0 0 0 40 0 0 0 0 0 0 0 0 0 0 0 0 0 0 0 0 0 0
0 0 16 13 13 13 13 13 13 13 13 13 16 0 0 0 0 0 16 0 0 64 84 84 84 84 84 84 84 84 84 84 84 84 84 84 66 0 0 0 0 0 40 0 0 0 0 0 0 0 0 0 0 0 0 0 0 0 0 0 0
0 0 16 13 13 13 13 13 13 13 13 13 13 0 0 0 0 0 16 0 0 64 84 84 84 84 84 84 84 84 84 84 84 84 84 84 66 0 0 0 0 0 40 0 0 0 0 0 0 0 0 0 0 0 0 0 0 0 0 0 0
0 0 16 13 13 13 13 13 13 13 13 13 13 0 0 60 0 0 16 0 0 64 84 84 84 84 84 84 84 84 84 84 84 84 84 84 66 0 0 0 0 0 40 0 0 0 0 0 0 0 0 0 0 0 0 0 0 0 0 0 0
0 0 16 13 13 13 13 13 13 13 13 13 13 0 0 40 0 0 16 0 0 64 84 84 84 84 84 84 84 84 84 84 84 84 84 84 66 0 0 0 0 0 40 0 0 0 0 0 0 0 0 0 0 0 0 0 0 0 0 0 0
0 0 16 13 13 13 13 13 13 13 13 13 16 0 0 40 0 0 16 0 0 64 84 84 84 84 84 84 84 84 84 84 84 84 84 84 66 0 0 0 0 0 40 0 0 0 0 0 0 0 0 0 0 0 0 0 0 0 0 0 0
0 0 16 13 13 13 13 13 13 13 13 13 16 16 16 40 16 16 16 0 0 64 84 84 84 84 84 84 84 84 84 84 84 84 84 84 66 0 0 0 0 0 40 0 0 0 0 0 0 0 0 0 0 0 0 0 0 0 0 0 0
0 0 16 13 13 13 13 13 13 13 13 13 16 0 0 40 0 0 0 0 0 64 84 84 84 84 84 84 84 84 84 84 84 84 84 84 66 0 0 0 0 0 40 0 0 0 0 0 0 0 0 0 0 0 0 0 0 0 0 0 0
0 0 16 37 13 37 13 37 13 37 13 37 16 0 0 40 0 0 0 0 0 64 84 84 84 84 84 84 84 84 84 84 84 84 84 84 66 0 0 0 0 0 40 0 0 0 0 0 0 0 0 0 0 0 0 0 0 0 0 0 0
0 0 16 16 16 16 16 16 16 16 16 16 16 0 0 40 0 0 0 0 0 64 84 84 84 84 84 84 84 84 84 84 84 84 84 84 66 0 0 0 0 0 40 0 0 0 0 0 0 0 0 0 0 0 0 0 0 0 0 0 0
0 0 0 0 0 0 0 0 0 0 0 0 0 0 0 40 0 0 0 0 0 64 84 84 84 84 84 84 84 84 84 84 84 84 84 84 66 0 0 0 0 0 40 0 0 0 0 0 0 0 0 0 0 0 0 0 0 0 0 0 0
0 0 0 0 0 0 0 0 0 0 0 0 0 0 0 40 0 0 0 0 0 64 84 84 84 84 84 84 84 84 84 84 84 84 84 84 66 0 0 0 0 0 40 0 0 0 0 0 0 0 0 0 0 0 0 0 0 0 0 0 0
0 0 0 0 0 0 0 0 0 0 0 0 0 0 0 40 0 0 0 0 0 64 84 84 84 84 84 84 84 84 84 84 84 84 84 84 66 0 0 0 0 0 40 0 0 0 0 0 0 0 0 0 0 0 0 0 0 0 0 0 0
0 0 0 0 0 0 0 0 0 0 0 0 0 0 0 40 0 0 0 0 0 64 84 84 84 84 84 84 84 84 84 84 84 84 84 84 66 0 0 0 0 0 40 0 0 0 0 0 0 0 0 0 0 0 0 0 0 0 0 0 0
0 0 0 0 0 0 0 0 0 0 0 0 0 0 0 40 0 0 0 0 0 64 84 84 84 84 84 84 84 84 84 84 84 84 84 84 66 0 0 0 0 0 40 0 0 0 0 0 0 0 0 0 0 0 0 0 0 0 0 0 0
0 0 0 0 0 0 0 0 0 0 0 0 0 0 0 40 0 0 0 0 0 64 84 84 84 84 84 84 84 84 84 84 84 84 84 84 66 0 0 0 0 0 40 0 0 0 0 0 0 0 0 0 0 0 0 0 0 0 0 0 0
0 0 0 0 0 0 0 0 0 0 0 0 0 0 0 40 0 0 0 0 0 64 84 84 84 84 84 84 84 84 84 84 84 84 84 84 66 0 0 0 0 0 40 0 0 0 0 0 0 0 0 0 0 0 0 0 0 0 0 0 0
0 0 0 0 0 0 0 0 0 0 0 0 0 0 0 40 0 0 0 0 0 64 84 84 84 84 84 84 84 84 84 84 84 84 84 84 66 0 0 0 0 0 40 0 0 0 0 0 0 0 0 0 0 0 0 0 0 0 0 0 0
0 0 0 0 0 0 0 0 0 0 0 0 0 0 0 40 0 0 0 0 0 64 84 84 84 84 84 84 84 84 84 84 84 84 84 84 66 0 0 0 0 0 40 0 0 0 0 0 0 0 0 0 0 0 0 0 0 0 0 0 0
0 0 0 0 0 0 0 0 0 0 0 0 0 0 0 40 0 0 0 0 0 64 84 84 84 84 84 84 84 84 84 84 84 84 84 84 66 0 0 0 0 0 40 0 0 0 0 0 0 0 0 0 0 0 0 0 0 0 0 0 0
0 0 0 0 0 0 0 0 0 0 0 0 0 0 0 40 16 0 0 16 0 64 16 84 84 16 84 84 16 56 84 84 56 84 84 56 66 0 56 0 0 56 40 0 0 0 0 0 0 0 0 0 0 0 0 0 0 0 0 0 0
0 0 0 0 0 0 0 0 0 0 0 0 0 0 0 40 41 41 41 41 41 41 41 41 41 41 41 41 41 41 41 41 41 41 41 41 41 41 41 41 41 41 40 0 0 0 0 0 0 0 0 0 0 0 0 0 0 0 0 0 0
0 0 0 0 0 0 0 0 0 0 0 0 0 0 0 40 41 41 41 41 41 41 41 41 41 41 41 41 41 41 41 41 41 41 41 41 41 41 41 41 41 41 40 0 0 0 0 0 0 0 0 0 0 0 0 0 0 0 0 0 0
0 0 0 0 0 0 0 0 0 0 0 0 0 0 0 40 41 41 41 41 41 41 41 41 41 41 41 41 41 41 41 41 41 41 41 41 41 41 41 41 41 41 40 0 0 0 0 0 0 0 0 0 0 0 0 0 0 0 0 0 0
0 0 0 0 0 0 0 0 0 0 0 0 0 0 0 40 41 41 41 41 41 41 41 41 41 41 41 41 41 41 41 41 41 41 41 41 41 41 41 41 41 41 40 0 0 0 0 0 0 0 0 0 0 0 0 0 0 0 0 0 0
0 0 0 0 0 0 0 0 0 0 0 0 0 0 0 40 16 0 0 16 0 64 16 84 84 16 84 84 16 56 84 84 56 84 84 56 66 0 56 0 0 56 40 0 0 0 0 0 0 0 0 0 0 0 0 0 0 0 0 0 0
0 0 0 0 0 0 0 0 0 0 0 0 0 0 0 40 0 0 0 0 0 64 84 84 84 84 84 84 84 84 84 84 84 84 84 84 66 0 0 0 0 0 40 0 0 0 0 0 0 0 0 0 0 0 0 0 0 0 0 0 0
0 0 0 0 0 0 0 0 0 0 0 0 0 0 0 40 0 0 0 0 0 64 84 84 84 84 84 84 84 84 84 84 84 84 84 84 66 0 0 0 0 0 40 0 0 0 0 0 0 0 0 0 0 0 0 0 0 0 0 0 0
0 0 0 0 0 0 0 0 0 0 0 0 0 0 0 40 0 0 0 0 0 64 84 84 84 84 84 84 84 84 84 84 84 84 84 84 66 0 0 0 0 0 40 0 0 0 0 0 0 0 0 0 0 0 0 0 0 0 0 0 0
0 0 0 0 0 0 0 0 0 0 0 0 0 0 0 40 0 0 0 0 0 64 84 84 84 84 84 84 84 84 84 84 84 84 84 84 66 0 0 0 0 0 40 0 0 0 0 0 0 0 0 0 0 0 0 0 0 0 0 0 0
0 0 0 0 0 0 0 0 0 0 0 0 0 0 0 40 0 0 0 0 0 64 84 84 84 84 84 84 84 84 84 84 84 84 84 84 66 0 0 0 0 0 40 0 0 0 0 0 0 0 0 0 0 0 0 0 0 0 0 0 0
0 0 0 0 0 0 0 0 0 0 0 0 0 0 0 40 0 0 0 0 0 64 84 84 84 84 84 84 84 84 84 84 84 84 84 84 66 0 0 0 0 0 40 0 0 0 0 0 0 0 0 0 0 0 0 0 0 0 0 0 0
0 0 0 0 0 0 0 0 0 0 0 0 0 0 0 40 0 0 0 0 0 64 84 84 84 84 84 84 84 84 84 84 84 84 84 84 66 0 0 0 0 0 40 0 0 0 0 0 0 0 0 0 0 0 0 0 0 0 0 0 0
0 0 0 0 0 0 0 0 0 0 0 0 0 0 0 40 0 0 0 0 0 64 84 84 84 84 84 84 84 84 84 84 84 84 84 84 66 0 0 0 0 0 40 0 0 0 0 0 0 0 0 0 0 0 0 0 0 0 0 0 0
0 0 0 0 0 0 0 0 0 0 0 0 0 0 0 40 0 0 0 0 0 64 84 84 84 84 84 84 84 84 84 84 84 84 84 84 66 0 0 0 0 0 40 0 0 0 0 0 0 0 0 0 0 0 0 0 0 0 0 0 0
0 0 0 0 0 0 0 0 0 0 0 0 0 0 0 40 0 0 0 0 0 64 84 84 84 84 84 84 84 84 84 84 84 84 84 84 66 0 0 0 0 0 40 0 0 0 0 0 0 0 0 0 0 0 0 0 0 0 0 0 0
0 0 0 0 0 0 0 0 0 0 0 0 0 0 0 40 0 0 0 0 0 64 84 84 84 84 84 84 84 84 84 84 84 84 84 84 66 0 0 0 0 0 40 0 0 56 56 56 56 56 56 56 56 56 56 56 0 0 0 0 0
0 0 0 0 0 0 0 0 0 0 0 0 0 0 0 40 0 0 0 0 0 64 84 84 84 84 84 84 84 84 84 84 84 84 84 84 66 0 0 0 0 0 40 0 0 56 39 15 39 15 39 15 39 15 39 56 0 0 0 0 0
0 0 0 0 0 0 0 0 0 0 0 0 0 0 0 40 0 0 0 0 0 64 84 84 84 84 84 84 84 84 84 84 84 84 84 84 66 0 0 0 0 0 40 0 0 56 15 15 15 15 15 15 15 15 15 56 0 0 0 0 0
0 0 0 0 0 0 0 0 0 0 0 0 0 0 0 40 0 0 0 0 0 64 84 84 84 84 84 84 84 84 84 84 84 84 84 84 66 0 0 56 56 56 40 56 56 56 15 15 15 15 15 15 15 15 15 56 0 0 0 0 0
0 0 0 0 0 0 0 0 0 0 0 0 0 0 0 40 0 0 0 0 0 64 84 84 84 84 84 84 84 84 84 84 84 84 84 84 66 0 0 56 0 0 40 0 0 56 15 15 15 15 15 15 15 15 15 56 0 0 0 0 0
0 0 0 0 0 0 0 0 0 0 0 0 0 0 0 40 0 0 0 0 0 64 84 84 84 84 84 84 84 84 84 84 84 84 84 84 66 0 0 56 0 0 40 0 0 15 15 15 15 15 15 15 15 15 15 56 0 0 0 0 0
0 0 0 0 0 0 0 0 0 0 0 0 0 0 0 40 0 0 0 0 0 64 84 84 84 84 84 84 84 84 84 84 84 84 84 84 66 0 0 56 0 0 60 0 0 15 15 15 15 15 15 15 15 15 15 56 0 0 0 0 0
0 0 0 0 0 0 0 0 0 0 0 0 0 0 0 40 0 0 0 0 0 64 84 84 84 84 84 84 84 84 84 84 84 84 84 84 66 0 0 56 0 0 0 0 0 15 15 15 15 15 15 15 15 15 15 56 0 0 0 0 0
0 0 0 0 0 0 0 0 0 0 0 0 0 0 0 40 0 0 0 0 0 64 84 84 84 84 84 84 84 84 84 84 84 84 84 84 66 0 0 56 0 0 0 0 0 56 15 15 15 15 15 15 15 15 15 56 0 0 0 0 0
0 0 0 0 0 0 0 0 0 0 0 0 0 0 0 40 0 0 0 0 0 64 84 84 84 84 84 84 84 84 84 84 84 84 84 84 66 0 0 56 56 56 56 56 56 56 56 56 56 56 56 56 56 56 56 56 0 0 0 0 0
0 0 0 0 0 0 0 0 0 0 0 0 0 0 0 40 0 0 0 0 0 64 84 84 84 84 84 84 84 84 84 84 84 84 84 84 66 0 0 0 0 0 0 0 0 0 0 0 0 0 0 0 0 0 0 0 0 0 0 0 0
0 0 0 0 0 0 0 0 0 0 0 0 0 0 0 40 0 0 0 0 0 64 84 84 84 84 84 84 84 84 84 84 84 84 84 84 66 0 0 0 0 0 0 0 0 0 0 0 0 0 0 0 0 0 0 0 0 0 0 0 0