72 72 72 72 72 72 72 72 72 72 72 72 72 72 72 72 72 72 72 72 72 72 72 72 72 72 72 72 72 72 72 15 0 0 38 0 38 0 38 0 38 0
72 72 72 72 72 72 72 72 72 72 72 72 72 72 72 76 39 72 72 72 72 72 72 72 72 39 76 72 72 72 72 15 0 0 0 0 56 56 56 56 0 39
72 72 72 72 72 72 72 72 72 72 72 72 72 72 72 72 72 72 72 72 38 38 72 72 72 72 72 72 72 72 72 15 0 0 0 0 0 0 0 0 56 0
72 72 72 72 72 72 72 72 72 72 72 72 72 72 72 72 72 72 72 72 76 76 72 72 72 72 72 72 72 72 72 14 0 0 0 0 0 0 60 0 56 39
72 72 72 72 72 72 72 72 72 72 72 72 72 72 72 72 72 72 72 72 72 72 72 72 72 72 72 72 72 72 72 14 0 0 0 0 0 0 0 0 56 0
72 72 72 72 72 72 72 72 72 72 72 72 72 72 72 72 72 72 72 72 72 72 72 72 72 72 72 72 72 72 72 14 0 0 0 38 56 0 0 0 56 39
72 72 72 72 72 72 72 72 72 72 72 72 72 72 72 72 72 72 72 72 72 72 72 72 72 72 72 72 72 72 72 38 0 0 0 0 39 0 0 0 0 0
76 15 15 15 15 15 12 12 12 12 12 16 16 16 16 16 16 16 12 12 12 12 12 12 16 16 16 16 16 16 16 56 0 0 0 0 0 0 0 0 0 39
0 0 0 0 0 0 0 0 0 0 12 84 84 84 84 84 84 84 84 84 84 84 84 84 84 84 84 84 84 84 84 13 0 0 0 0 0 0 0 0 0 0
0 0 0 0 0 0 0 0 0 0 12 84 84 84 84 84 84 84 84 84 84 84 84 84 84 84 84 84 84 84 84 13 0 0 0 0 0 0 0 0 0 0
0 0 0 0 0 0 0 0 0 0 13 84 84 84 84 84 84 84 84 84 84 84 84 84 84 84 84 84 84 84 84 12 0 0 0 0 0 0 0 0 0 0
0 0 0 0 0 0 0 0 0 0 13 84 84 84 84 84 84 84 84 84 84 84 84 84 84 84 84 84 84 84 84 12 0 0 0 0 0 0 0 0 0 0
0 0 0 0 0 0 0 0 0 0 40 16 16 16 16 16 16 16 13 13 13 13 13 13 16 16 16 16 16 16 16 40 0 0 0 0 0 0 0 0 0 0
0 0 0 0 0 0 0 0 0 0 14 41 41 41 41 41 41 41 41 41 41 41 41 41 41 41 41 41 41 41 41 13 0 0 0 0 0 0 0 0 0 0
0 0 0 0 0 0 0 0 0 0 14 41 41 41 41 41 41 41 41 41 41 41 41 41 41 41 41 41 41 41 41 13 0 0 0 0 0 0 0 0 0 0
0 0 0 0 0 0 0 0 0 0 15 41 41 41 41 41 41 41 41 41 41 41 41 41 41 41 41 41 41 41 41 12 0 0 0 0 0 0 0 0 0 0
0 0 0 0 0 0 0 0 0 0 15 41 41 41 41 41 41 41 41 41 41 41 41 41 41 41 41 41 41 41 41 12 0 0 0 0 0 0 0 0 0 0
0 0 0 0 0 0 0 0 0 0 40 16 16 16 16 16 16 16 12 12 12 12 12 12 16 16 16 16 16 16 16 40 0 0 0 0 0 0 0 0 0 0
0 0 0 0 0 0 0 0 0 0 14 24 24 24 24 24 24 24 24 24 24 24 24 24 24 24 24 24 24 24 24 15 0 0 0 0 0 0 0 0 0 0
0 0 0 0 0 0 0 0 0 0 14 24 24 24 24 24 24 24 24 24 24 24 24 24 24 24 24 24 24 24 24 15 0 0 0 0 0 0 0 0 0 0
0 0 0 0 0 0 0 0 0 0 15 24 24 24 24 24 24 24 24 24 24 24 24 24 24 24 24 24 24 24 24 14 0 0 0 0 0 0 0 0 0 0
0 0 0 0 0 0 0 0 0 0 15 24 24 24 24 24 24 24 24 24 24 24 24 24 24 24 24 24 24 24 24 14 0 0 0 0 0 0 0 0 0 0
37 0 0 0 0 0 0 0 0 0 56 16 16 16 16 16 16 16 13 13 13 13 13 13 16 16 16 16 16 16 16 14 14 14 14 14 13 13 13 13 13 56
0 0 0 0 0 37 0 0 0 0 36 48 52 48 52 48 52 48 52 48 52 48 52 48 52 48 52 48 52 48 52 48 52 48 52 48 52 48 52 48 52 48
37 56 0 0 0 56 36 0 0 0 12 52 48 52 48 52 48 52 48 52 48 52 48 52 48 52 48 52 48 52 48 52 48 52 48 52 48 52 48 52 48 52
0 56 0 0 0 0 0 0 0 0 12 48 52 48 52 48 52 48 52 48 52 48 52 48 52 48 52 48 52 48 52 48 52 48 52 48 52 48 52 48 52 48
37 56 0 60 0 0 0 0 0 0 12 52 48 52 48 52 48 52 48 52 56 56 48 52 48 52 48 52 48 52 48 52 48 52 48 52 48 52 48 52 48 52
0 56 0 0 0 0 0 0 0 0 13 48 52 48 52 48 52 48 52 48 36 36 52 48 52 48 52 48 52 48 52 48 52 48 52 48 52 48 52 48 52 48
37 0 56 56 56 56 0 0 0 0 13 52 48 52 48 56 37 52 48 52 48 52 48 52 48 37 56 52 48 52 48 52 48 52 48 52 48 52 48 52 48 52
0 36 0 36 0 36 0 36 0 0 13 48 52 48 52 48 52 48 52 48 52 48 52 48 52 48 52 48 52 48 52 48 52 48 52 48 52 48 52 48 52 48