39 72 42 12 72 72 72 72 60 72 72 72 72 12 42 72 39
72 72 42 12 72 72 72 72 72 72 72 72 72 12 42 72 72
72 72 42 16 72 72 72 72 72 72 72 72 72 16 42 72 72
72 72 42 16 36 72 72 72 72 72 72 72 38 16 42 72 72
72 72 42 16 16 16 12 16 16 16 12 16 16 16 42 72 72
72 72 42 72 72 72 72 72 72 72 72 72 72 72 42 72 72
72 72 43 41 41 41 41 41 42 41 41 41 41 41 43 72 72
72 72 72 72 72 72 72 72 40 72 72 72 72 72 72 72 72
72 72 72 72 72 72 72 72 40 72 72 72 72 72 72 72 72
72 72 72 72 72 72 72 72 40 72 72 72 72 72 72 72 72
72 72 72 72 72 72 72 72 40 72 72 72 72 72 72 72 72
72 72 72 72 72 72 72 72 40 72 72 72 72 72 72 72 72
72 72 72 72 72 72 72 72 40 72 72 72 72 72 72 72 72
72 72 72 72 72 72 72 72 40 72 72 72 72 72 72 72 72
36 72 72 72 72 72 72 72 40 72 72 72 72 72 72 72 38
76 76 72 72 72 72 72 72 40 72 72 72 72 72 72 76 76
72 72 72 72 72 72 72 72 40 72 72 72 72 72 72 72 72
72 72 72 72 72 72 72 72 40 72 72 72 72 72 72 72 72
72 72 72 72 72 72 72 72 40 72 72 72 72 72 72 72 72
72 72 72 72 72 72 72 72 40 72 72 72 72 72 72 72 72
72 72 72 72 72 72 72 72 40 72 72 72 72 72 72 72 72
72 72 72 72 72 72 72 72 40 72 72 72 72 72 72 72 72
72 72 72 72 72 72 72 72 40 72 72 72 72 72 72 72 72
72 72 72 72 72 72 72 72 40 72 72 72 72 72 72 72 72
36 72 72 72 72 72 72 72 40 72 72 72 72 72 72 72 38
76 76 76 72 72 72 72 72 40 72 72 72 72 72 76 76 76
72 72 72 72 72 72 72 72 40 72 72 72 72 72 72 72 72
72 72 72 72 72 72 72 72 40 72 72 72 72 72 72 72 72
72 72 72 72 72 72 72 72 40 72 72 72 72 72 72 72 72
72 72 72 72 72 72 72 72 40 72 72 72 72 72 72 72 72
72 72 72 72 72 72 72 72 40 72 72 72 72 72 72 72 72
72 72 72 72 72 72 72 72 40 72 72 72 72 72 72 72 72
72 72 72 72 72 72 72 72 40 72 72 72 72 72 72 72 72
72 72 72 72 72 72 72 72 40 72 72 72 72 72 72 72 72
72 72 72 72 72 72 72 72 40 72 72 72 72 72 72 72 72
72 72 72 72 72 72 72 72 40 72 72 72 72 72 72 72 72
72 72 72 72 72 72 72 72 40 72 72 72 72 72 72 72 72
72 72 72 72 72 72 72 72 40 72 72 72 72 72 72 72 72
72 72 72 72 72 72 72 72 40 72 72 72 72 72 72 72 72
72 72 72 72 72 72 72 72 40 72 72 72 72 72 72 72 72
72 72 72 72 72 72 72 72 40 72 72 72 72 72 72 72 72
72 72 72 72 72 72 72 72 40 72 72 72 72 72 72 72 72
72 72 72 72 72 72 72 72 40 72 72 72 72 72 72 72 72
72 72 72 72 72 72 72 72 40 72 72 72 72 72 72 72 72
72 72 72 72 72 72 72 72 40 72 72 72 72 72 72 72 72
72 72 72 72 72 72 72 72 40 72 72 72 72 72 72 72 72
72 72 72 72 72 72 72 72 40 72 72 72 72 72 72 72 72
72 72 72 72 72 72 72 72 40 72 72 72 72 72 72 72 72
72 16 16 16 16 16 72 72 40 72 72 16 16 16 16 16 72
72 16 12 12 12 16 72 72 40 72 72 16 12 12 12 16 72
12 16 12 12 12 12 12 12 40 12 12 12 12 12 12 16 12
72 16 12 12 12 16 72 72 40 72 72 16 12 12 12 16 72
72 16 16 16 16 16 72 72 40 72 72 16 16 16 16 16 72
72 72 72 72 72 72 72 72 40 72 72 72 72 72 72 72 72
72 72 72 72 72 72 72 72 40 72 72 72 72 72 72 72 72
72 72 72 72 72 72 72 72 40 72 72 72 72 72 72 72 72
72 72 72 72 72 72 72 72 40 72 72 72 72 72 72 72 72
72 72 72 72 72 72 72 72 40 72 72 72 72 72 72 72 72
72 72 72 72 72 72 72 72 40 72 72 72 72 72 72 72 72
72 72 72 72 72 72 72 72 40 72 72 72 72 72 72 72 72
72 72 72 72 72 72 72 72 40 72 72 72 72 72 72 72 72
72 72 72 72 72 72 72 72 40 72 72 72 72 72 72 72 72
72 72 72 72 72 72 72 72 40 72 72 72 72 72 72 72 72
72 72 72 72 72 72 72 72 40 72 72 72 72 72 72 72 72
72 72 72 72 72 72 72 72 40 72 72 72 72 72 72 72 72
72 72 72 72 72 72 72 72 40 72 72 72 72 72 72 72 72
72 72 72 72 72 72 72 72 40 72 72 72 72 72 72 72 72
72 72 72 72 72 72 72 72 40 72 72 72 72 72 72 72 72
72 72 72 72 72 72 72 72 40 72 72 72 72 72 72 72 72
72 72 72 72 72 72 72 72 40 72 72 72 72 72 72 72 72
72 72 72 72 72 72 72 72 40 72 72 72 72 72 72 72 72
72 72 72 72 72 72 72 72 40 72 72 72 72 72 72 72 72
72 72 72 72 72 72 72 72 40 72 72 72 72 72 72 72 72
72 72 72 72 72 72 72 72 40 72 72 72 72 72 72 72 72
72 72 72 72 72 72 72 72 40 72 72 72 72 72 72 72 72
76 76 76 72 72 72 72 72 40 72 72 72 72 72 76 76 76
36 72 72 72 72 72 72 72 40 72 72 72 72 72 72 72 38
72 72 72 72 72 72 72 72 40 72 72 72 72 72 72 72 72
72 72 72 72 72 72 72 72 40 72 72 72 72 72 72 72 72
72 72 72 72 72 72 72 72 40 72 72 72 72 72 72 72 72
72 72 72 72 72 72 72 72 40 72 72 72 72 72 72 72 72
72 72 72 72 72 72 72 72 40 72 72 72 72 72 72 72 72
72 72 72 72 72 72 72 72 40 72 72 72 72 72 72 72 72
72 72 72 72 72 72 72 72 40 72 72 72 72 72 72 72 72
72 72 72 72 72 72 72 72 40 72 72 72 72 72 72 72 72
76 76 72 72 72 72 72 72 40 72 72 72 72 72 72 76 76
36 72 72 72 72 72 72 72 40 72 72 72 72 72 72 72 38
72 72 72 72 72 72 72 72 40 72 72 72 72 72 72 72 72
72 72 72 72 72 72 72 72 40 72 72 72 72 72 72 72 72
72 72 72 72 72 72 72 72 40 72 72 72 72 72 72 72 72
72 72 72 72 72 72 72 72 40 72 72 72 72 72 72 72 72
72 72 72 72 72 72 72 72 40 72 72 72 72 72 72 72 72
72 72 72 72 72 72 72 72 40 72 72 72 72 72 72 72 72
72 72 43 41 41 41 41 41 40 41 41 41 41 41 43 72 72
72 72 42 72 72 72 72 72 72 72 72 72 72 72 42 72 72
72 72 42 16 16 16 12 16 16 16 12 16 16 16 42 72 72
72 72 42 16 36 72 72 72 72 72 72 72 38 16 42 72 72
72 72 42 16 72 72 72 72 72 72 72 72 72 16 42 72 72
72 72 42 12 72 72 72 72 72 72 72 72 72 12 42 72 72
37 72 42 12 72 72 72 72 60 72 72 72 72 12 42 72 37