62 83 72 80 16 0 0 0 0 0 0 0 64 84 84 84 84 84 84 84 84 84 84 84 84 84 84 84 84 84 84 84 84 84 84 66 56 12 56 39 56 39 56 39 56 39 56 39 56 12
81 82 72 81 0 0 0 0 0 0 0 0 64 84 84 84 84 84 84 84 84 84 84 84 84 84 84 84 84 84 84 84 84 84 84 66 56 56 0 0 0 0 0 0 0 0 0 0 0 56
72 72 72 80 16 0 0 0 0 0 0 0 64 84 65 65 65 65 65 65 65 65 65 84 84 84 84 84 84 84 84 84 84 84 84 66 56 36 0 0 0 0 0 0 0 0 0 0 0 38
80 83 80 0 0 0 0 0 0 0 0 0 64 66 40 41 41 41 41 41 41 41 42 64 84 84 84 84 84 84 84 84 84 84 84 66 56 56 0 0 0 56 56 56 56 56 0 0 0 56
16 0 16 0 0 0 0 0 0 0 0 0 64 66 40 41 41 41 41 41 41 41 42 64 84 84 84 84 84 84 84 84 84 84 84 66 56 36 0 0 0 56 56 56 56 56 0 0 0 38
0 0 0 0 0 0 0 0 0 0 0 0 64 66 40 40 68 67 67 67 71 42 42 69 65 65 84 84 84 84 84 84 84 84 84 66 56 56 0 0 0 56 56 56 56 56 0 0 0 56
0 0 0 0 0 0 0 0 0 0 0 0 64 66 4 40 64 84 84 84 66 42 43 43 43 40 69 65 65 65 65 84 84 84 84 66 56 36 0 0 0 0 0 0 0 0 0 0 0 38
0 0 0 0 0 0 0 0 0 0 0 0 64 66 4 40 64 84 84 84 66 42 41 41 41 42 43 43 43 43 40 64 84 84 84 66 56 56 0 0 0 0 0 0 0 0 0 0 0 56
67 67 67 67 67 67 67 67 67 67 67 67 86 66 4 40 64 84 84 84 84 67 67 71 41 41 41 41 41 40 40 64 84 84 84 66 56 13 0 0 0 56 40 40 56 0 0 0 0 13
84 84 84 84 84 65 65 65 65 65 65 65 65 66 4 2 69 65 84 84 84 84 84 84 67 67 67 67 71 40 40 64 84 84 84 84 67 67 67 67 67 67 40 40 67 67 67 67 67 67
84 84 84 84 66 42 43 43 43 0 0 0 0 0 0 6 0 0 69 86 86 86 84 84 84 84 84 84 66 40 40 69 65 65 65 65 84 84 84 84 84 84 40 40 86 84 84 84 84 84
84 84 84 84 66 42 43 43 43 43 43 43 43 43 43 0 0 0 0 69 86 86 84 84 84 84 84 84 66 40 41 41 41 41 41 42 64 84 84 84 84 84 40 40 86 84 84 84 84 84
84 84 84 84 66 42 42 68 67 67 67 67 67 67 67 71 0 0 0 0 69 86 84 84 84 84 84 84 66 40 41 41 41 41 41 42 64 84 84 84 84 84 40 40 84 84 84 84 84 84
84 84 84 84 66 42 42 64 86 86 86 86 86 86 86 86 71 0 0 0 0 69 84 84 84 84 84 84 84 67 67 67 67 71 42 42 64 84 84 84 84 84 40 40 84 84 84 84 84 84
84 84 84 84 66 42 42 64 86 86 86 86 86 86 86 86 86 71 0 0 0 6 69 84 84 84 84 84 84 84 84 84 84 66 42 42 69 65 65 65 65 65 40 40 84 84 84 84 84 84
84 84 84 84 66 42 42 64 86 86 86 86 86 86 86 86 86 86 71 0 0 6 2 69 84 84 84 84 84 84 84 84 84 66 42 42 43 43 43 43 43 43 40 40 64 84 84 84 84 84
84 84 84 84 66 42 42 64 86 86 86 86 86 86 86 86 86 86 86 71 0 0 6 6 69 86 86 86 86 86 86 86 86 66 42 43 43 43 43 43 43 43 40 40 64 84 84 84 84 84
84 84 84 84 66 42 42 64 86 86 86 86 86 86 86 86 86 86 86 86 71 0 0 6 6 69 86 86 86 86 86 86 86 86 67 67 67 67 67 67 67 71 40 40 64 84 84 84 84 84
84 84 84 84 66 42 42 64 86 86 86 86 86 86 86 86 86 86 86 86 86 71 0 0 6 6 69 86 86 86 86 86 86 86 86 86 84 84 84 84 84 66 40 40 64 84 84 84 84 84
84 84 84 84 66 42 42 64 86 86 86 86 86 86 86 86 86 86 86 86 86 86 71 0 0 6 6 69 86 86 86 86 86 86 86 86 84 84 84 84 84 66 40 40 64 84 84 84 84 84
84 84 84 84 66 42 42 64 86 86 86 86 86 86 86 86 86 86 86 86 86 86 86 71 0 0 6 6 69 86 86 86 86 86 86 86 84 84 84 84 84 66 40 40 64 84 84 84 84 84
84 84 84 84 66 42 42 69 65 65 65 65 65 65 65 65 86 86 86 86 86 86 86 86 71 0 0 6 6 69 86 86 86 86 86 86 84 84 84 84 84 66 40 40 64 84 84 84 84 84
84 84 84 84 66 42 42 41 41 41 41 41 41 41 41 40 64 86 86 86 86 86 86 86 86 71 0 0 6 6 69 86 86 86 86 86 84 84 84 84 84 66 40 40 64 84 84 84 84 84
84 84 84 84 66 42 42 41 41 41 41 41 41 41 40 40 64 86 86 86 86 86 86 86 86 86 71 0 0 6 6 69 86 86 86 86 84 84 84 84 84 66 40 40 64 84 84 84 84 84
84 84 84 84 84 42 42 67 67 67 67 67 67 67 40 40 64 86 86 86 86 86 86 86 86 86 86 71 0 0 6 6 69 86 86 86 84 84 84 84 84 66 40 40 64 84 84 84 84 84
84 84 84 84 84 42 42 86 86 86 86 86 86 66 40 40 69 65 65 65 65 86 86 86 86 86 86 86 71 0 0 0 6 69 86 86 84 84 84 84 84 66 40 40 64 84 84 84 84 84
84 84 84 84 84 42 42 86 86 86 86 86 86 66 40 43 43 43 43 43 42 64 86 86 86 86 86 86 86 71 0 0 6 6 69 86 84 84 84 84 84 66 40 40 64 84 84 84 84 84
84 84 84 84 84 42 42 86 86 86 86 86 86 66 40 43 43 43 43 43 42 64 86 86 86 86 86 86 86 86 71 0 0 0 6 69 65 65 65 65 65 70 40 40 64 84 84 84 84 84
84 84 84 84 84 42 42 86 86 86 86 86 86 86 67 67 67 67 67 42 42 64 86 86 86 86 86 86 86 86 86 71 0 0 6 6 41 41 41 41 41 41 40 40 64 84 84 84 84 84
84 84 84 84 84 42 42 86 86 86 86 86 86 86 86 86 86 86 66 42 42 69 65 65 65 65 86 86 86 86 86 86 71 0 0 0 2 2 2 2 41 41 41 40 64 84 84 84 84 84
65 65 65 65 65 42 42 65 65 65 65 65 65 65 86 86 86 86 66 42 41 41 41 41 41 40 69 65 65 86 86 86 86 71 0 6 68 67 67 67 67 67 67 67 84 84 84 84 84 84
12 2 2 2 56 42 42 56 2 2 2 2 14 16 64 86 86 86 66 42 41 41 41 41 40 40 41 41 40 64 86 86 86 66 42 6 64 84 65 65 65 65 65 65 65 65 65 65 65 65
16 2 2 2 2 2 2 2 2 2 2 2 16 16 64 86 86 86 86 67 67 67 67 67 42 41 41 41 40 64 86 86 86 66 42 6 64 66 2 2 2 2 2 2 2 2 2 2 2 2
36 2 2 2 2 2 2 2 2 2 2 2 38 16 64 86 86 86 86 86 86 86 86 86 67 67 86 40 40 64 86 86 86 66 42 6 64 66 2 2 2 2 2 2 2 2 2 2 2 2
16 2 2 2 56 56 56 56 56 2 2 2 16 16 64 86 86 86 86 86 86 86 86 86 86 86 66 40 40 69 65 65 65 70 42 42 64 66 2 2 2 2 2 2 2 2 2 2 2 2
36 2 2 2 56 56 56 56 56 2 2 2 38 16 64 86 86 86 86 86 86 86 86 86 86 86 66 40 43 43 43 43 43 43 43 42 64 66 2 2 2 2 2 2 2 2 2 56 2 56
16 2 2 2 56 56 56 56 56 2 2 2 16 16 64 86 86 86 86 86 86 86 86 86 86 86 66 43 43 43 43 43 43 43 43 42 64 66 2 2 2 2 2 2 2 2 2 82 81 82
36 2 2 2 2 2 2 2 2 2 2 2 38 16 64 84 84 84 84 84 84 84 84 84 84 84 84 67 67 67 67 67 67 67 67 67 84 66 2 2 2 2 2 2 2 56 82 74 74 74
16 2 2 2 2 2 2 2 2 2 2 2 16 16 64 84 84 84 84 84 84 84 84 84 84 84 84 84 84 84 84 84 84 84 84 84 84 66 2 2 2 2 2 2 2 2 83 74 80 83
13 16 37 16 37 16 37 16 37 16 37 16 13 16 64 84 84 84 84 84 84 84 84 84 84 84 84 84 84 84 84 84 84 84 84 84 84 66 2 2 2 2 2 2 2 56 82 74 81 60