0 0 0 0 0 0 0 0 0 0 0 0 0 0 0 0 0 0 0 0 0 0 0 0 0 0 0 0 64 84 84 84 84 84 84 84 84 84 84 84 84 84 84 84 84 66 0 0 0 0 0 0 0 0 0 0 0 0 0 0 0 0 0 0 0 0 0 0 0 0 0 0 0 0
0 0 0 0 0 0 0 0 0 0 0 0 0 0 0 0 0 0 0 0 0 0 0 0 0 0 0 0 64 84 84 84 84 84 84 84 84 84 84 84 84 84 84 84 84 66 0 0 0 0 0 0 0 0 0 0 0 0 0 0 0 0 0 0 0 0 0 0 0 0 0 0 0 0
0 0 0 0 0 0 0 0 0 0 0 0 0 0 0 0 0 0 0 0 0 0 0 0 0 0 0 0 64 84 84 84 84 84 84 84 84 84 84 84 84 84 84 84 84 66 0 0 0 0 0 0 0 0 0 0 0 0 0 0 0 0 0 0 0 0 0 0 0 0 0 0 0 0
0 0 0 0 0 0 0 0 0 0 0 0 0 0 0 0 0 0 0 0 0 0 0 0 0 0 0 0 64 84 84 84 84 84 84 84 84 84 84 84 84 84 84 84 84 66 0 0 0 0 0 0 0 0 0 0 0 0 0 0 0 0 0 0 0 0 0 0 0 0 0 0 0 0
0 0 0 0 0 0 0 0 0 0 0 0 0 0 0 0 0 0 0 0 0 0 0 0 0 0 0 0 64 84 84 84 84 84 84 84 84 84 84 84 84 84 84 84 84 66 0 0 0 0 0 0 0 0 0 0 0 0 0 0 0 0 0 0 0 0 0 0 0 0 0 0 0 0
0 0 0 0 0 12 41 41 41 41 41 41 41 41 41 12 0 0 0 0 0 0 0 0 0 0 0 0 64 84 84 84 84 84 84 84 84 84 84 84 84 84 84 84 84 66 0 0 0 0 0 0 0 0 0 0 0 0 12 41 41 41 41 41 41 41 41 41 12 0 0 0 0 0
0 0 0 0 0 42 0 0 0 0 0 0 0 0 0 40 0 0 0 0 0 0 0 0 0 0 0 0 64 84 84 84 84 2 2 2 2 2 2 2 2 84 84 84 84 66 0 0 0 0 0 0 0 0 0 0 0 0 40 0 0 0 0 0 0 0 0 0 42 0 0 0 0 0
0 0 0 0 0 42 0 0 0 0 0 0 0 0 0 40 0 0 0 0 0 0 12 41 41 41 41 41 41 41 41 41 41 41 41 41 41 41 41 41 41 41 41 41 41 41 41 41 41 41 41 12 0 0 0 0 0 0 40 0 0 0 0 0 0 0 0 0 42 0 0 0 0 0
0 0 0 0 0 42 0 0 0 0 0 0 0 0 0 40 0 0 0 0 0 0 40 0 0 0 0 0 64 84 84 84 66 0 0 0 0 0 0 0 0 64 84 84 84 66 0 0 0 0 0 40 0 0 0 0 0 0 40 0 0 0 0 0 0 0 0 0 42 0 0 0 0 0
16 16 16 16 0 42 0 16 16 16 16 0 0 0 0 40 0 0 0 0 0 0 40 0 0 16 16 0 64 84 84 84 66 0 0 0 0 0 0 0 0 64 84 84 84 66 0 16 16 0 0 40 0 0 0 0 0 0 40 0 0 0 0 16 16 16 16 0 42 0 16 16 16 16
16 12 12 39 0 42 0 39 15 15 16 0 0 0 0 40 0 0 0 0 0 0 40 0 0 16 16 0 64 84 84 84 66 0 0 0 0 0 0 0 0 64 84 84 84 66 0 16 16 0 0 40 0 0 0 0 0 0 40 0 0 0 0 16 15 15 39 0 42 0 39 12 12 16
16 12 0 0 0 42 0 0 0 38 16 0 0 0 0 40 0 0 0 0 0 0 40 0 0 16 16 0 64 84 84 84 66 0 0 0 0 0 0 0 0 64 84 84 84 66 0 16 16 0 0 40 0 0 0 0 0 0 40 0 0 0 0 16 36 0 0 0 42 0 0 0 12 16
16 36 0 0 0 42 0 0 0 14 16 0 0 0 0 40 0 0 0 0 0 0 40 0 0 16 16 0 64 84 84 84 66 0 0 0 0 0 0 0 0 64 84 84 84 66 0 16 16 0 0 40 0 0 0 0 0 0 40 0 0 0 0 16 14 0 0 0 42 0 0 0 38 16
16 12 0 0 0 42 0 0 0 14 16 0 0 0 0 42 0 0 0 0 0 0 40 0 0 16 16 0 64 84 84 84 66 0 0 0 0 0 0 0 0 64 84 84 84 66 0 16 16 0 0 40 0 0 0 0 0 0 42 0 0 0 0 16 14 0 0 0 42 0 0 0 12 16
16 12 0 0 0 42 0 0 0 38 16 16 0 0 0 42 0 0 0 0 0 0 40 0 0 16 16 0 64 84 84 84 66 0 0 0 0 0 0 0 0 64 84 84 84 66 0 16 16 0 0 40 0 0 0 0 0 0 42 0 0 0 16 16 36 0 0 0 42 0 0 0 12 16
16 36 0 0 0 42 0 0 0 0 0 16 16 0 0 42 0 0 0 0 0 0 40 0 0 16 16 0 64 84 84 84 66 0 0 0 0 0 0 0 0 64 84 84 84 66 0 16 16 0 0 40 0 0 0 0 0 0 42 0 0 16 16 0 0 0 0 0 42 0 0 0 38 16
16 12 0 0 0 42 0 0 0 0 0 0 0 0 0 42 0 0 0 0 0 0 40 0 0 0 0 0 64 84 84 84 66 0 0 0 0 0 0 0 0 64 84 84 84 66 0 0 0 0 0 40 0 0 0 0 0 0 42 0 0 0 0 0 0 0 0 0 42 0 0 0 12 16
16 12 0 0 0 60 41 41 41 41 41 41 41 41 41 14 41 41 41 41 41 41 12 41 41 41 41 41 41 41 41 41 41 41 41 41 41 41 41 41 41 41 41 41 41 41 41 41 41 41 41 12 41 41 41 41 41 41 14 41 41 41 41 41 41 41 41 41 60 0 0 0 12 16
16 12 0 0 0 42 0 0 0 0 0 0 0 0 0 42 0 0 0 0 0 0 40 0 0 0 0 0 64 84 84 84 66 0 0 0 0 0 0 0 0 64 84 84 84 66 0 0 0 0 0 40 0 0 0 0 0 0 42 0 0 0 0 0 0 0 0 0 42 0 0 0 12 16
16 36 0 0 0 42 0 0 0 0 0 16 16 0 0 42 0 0 0 0 0 0 40 0 0 16 16 0 64 84 84 84 66 0 0 0 0 0 0 0 0 64 84 84 84 66 0 16 16 0 0 40 0 0 0 0 0 0 42 0 0 16 16 0 0 0 0 0 42 0 0 0 38 16
16 12 0 0 0 42 0 0 0 38 16 16 0 0 0 42 0 0 0 0 0 0 40 0 0 16 16 0 64 84 84 84 66 0 0 0 0 0 0 0 0 64 84 84 84 66 0 16 16 0 0 40 0 0 0 0 0 0 42 0 0 0 16 16 36 0 0 0 42 0 0 0 12 16
16 12 0 0 0 42 0 0 0 14 16 0 0 0 0 42 0 0 0 0 0 0 40 0 0 16 16 0 64 84 84 84 66 0 0 0 0 0 0 0 0 64 84 84 84 66 0 16 16 0 0 40 0 0 0 0 0 0 42 0 0 0 0 16 14 0 0 0 42 0 0 0 12 16
16 36 0 0 0 42 0 0 0 14 16 0 0 0 0 40 0 0 0 0 0 0 40 0 0 16 16 0 64 84 84 84 66 0 0 0 0 0 0 0 0 64 84 84 84 66 0 16 16 0 0 40 0 0 0 0 0 0 40 0 0 0 0 16 14 0 0 0 42 0 0 0 38 16
16 12 2 2 2 40 2 2 2 38 16 2 2 2 2 42 2 2 2 2 2 2 40 0 0 16 16 0 64 84 84 84 66 0 0 0 0 0 0 0 0 64 84 84 84 66 0 16 16 0 0 40 2 2 2 2 2 2 42 2 2 2 2 16 36 2 2 2 40 2 2 2 12 16
16 12 12 37 2 40 2 37 14 14 16 2 2 2 2 42 2 2 2 2 2 2 40 0 0 16 16 0 64 84 84 84 66 0 0 0 0 0 0 0 0 64 84 84 84 66 0 16 16 0 0 40 2 2 2 2 2 2 42 2 2 2 2 16 14 14 37 2 40 2 37 12 12 16
16 16 16 16 2 40 2 16 16 16 16 2 2 2 2 42 2 2 2 2 2 2 40 0 0 16 16 0 64 84 84 84 66 0 0 0 0 0 0 0 0 64 84 84 84 66 0 16 16 0 0 40 2 2 2 2 2 2 42 2 2 2 2 16 16 16 16 2 40 2 16 16 16 16
2 2 2 2 2 40 2 2 2 2 2 2 2 2 2 42 2 2 2 2 2 2 40 0 0 0 0 0 64 84 84 84 66 0 0 0 0 0 0 0 0 64 84 84 84 66 0 0 0 0 0 40 2 2 2 2 2 2 42 2 2 2 2 2 2 2 2 2 40 2 2 2 2 2
2 2 2 2 2 40 2 2 2 2 2 2 2 2 2 42 2 2 2 2 2 2 12 41 41 41 41 41 41 41 41 41 41 41 41 41 41 41 41 41 41 41 41 41 41 41 41 41 41 41 41 12 2 2 2 2 2 2 42 2 2 2 2 2 2 2 2 2 40 2 2 2 2 2
2 2 2 2 2 40 2 2 2 2 2 2 2 2 2 42 2 2 2 2 2 2 2 0 0 0 0 0 64 84 84 84 66 0 0 0 0 0 0 0 0 84 84 84 84 66 0 0 0 0 0 2 2 2 2 2 2 2 42 2 2 2 2 2 2 2 2 2 40 2 2 2 2 2
2 2 2 2 2 14 43 43 43 43 43 43 43 43 43 14 2 2 2 2 2 2 2 0 0 0 0 0 64 84 84 84 84 67 67 67 67 67 67 67 67 84 84 84 84 66 0 0 0 0 0 2 2 2 2 2 2 2 14 43 43 43 43 43 43 43 43 43 14 2 2 2 2 2
2 2 2 2 2 2 2 2 2 2 2 2 2 2 2 2 2 2 2 2 2 2 2 0 0 0 0 0 64 84 84 84 84 84 84 84 84 84 84 84 84 84 84 84 84 66 0 0 0 0 0 2 2 2 2 2 2 2 2 2 2 2 2 2 2 2 2 2 2 2 2 2 2 2
2 2 2 2 2 2 2 2 2 2 2 2 2 2 2 2 2 2 2 2 2 2 0 0 0 0 0 0 64 84 84 84 84 84 84 84 84 84 84 84 84 84 84 84 84 66 0 0 0 0 0 0 0 0 0 0 0 0 0 0 0 0 0 0 0 0 0 0 0 0 0 0 0 0
2 2 2 2 2 2 2 2 2 2 2 2 2 2 2 2 2 2 2 2 2 2 0 0 0 0 0 0 64 84 84 84 84 84 84 84 84 84 84 84 84 84 84 84 84 66 0 0 0 0 0 0 0 0 0 0 0 0 0 0 0 0 0 0 0 0 0 0 0 0 0 0 0 0
2 2 2 2 2 2 2 2 2 2 2 2 2 2 2 2 2 2 2 2 2 2 0 0 0 0 0 0 64 84 84 84 84 84 84 84 84 84 84 84 84 84 84 84 84 66 0 0 0 0 0 0 0 0 0 0 0 0 0 0 0 0 0 0 0 0 0 0 0 0 0 0 0 0
2 2 2 2 2 2 2 2 2 2 2 2 2 2 2 2 2 2 2 2 2 2 0 0 0 0 0 0 64 84 84 84 84 84 84 84 84 84 84 84 84 84 84 84 84 66 0 0 0 0 0 0 0 0 0 0 0 0 0 0 0 0 0 0 0 0 0 0 0 0 0 0 0 0