48 48 48 48 48 48 48 48 48 48 48 48 48 48 48 48 48 48 48 48 48 48 48 56 56 56 56 48 48 48 48 48 48 48 48 48 48 48 48 48 48 48 48 48 48 48 48 48 48 48
48 48 48 52 52 48 48 48 48 48 48 48 48 48 48 48 48 48 48 48 48 48 48 56 56 56 56 48 48 52 48 48 48 48 48 48 48 48 48 48 48 48 48 48 48 48 48 48 48 48
48 48 52 48 52 52 48 48 48 48 48 48 48 48 48 48 48 48 48 48 48 48 48 56 56 56 56 48 52 48 52 48 48 48 48 48 52 48 48 48 48 48 48 48 48 48 48 48 48 48
48 48 52 48 52 52 48 52 48 48 48 48 48 48 48 48 48 48 48 48 48 48 48 56 56 56 56 48 52 48 48 48 48 48 48 48 52 48 48 48 48 48 48 48 48 52 48 48 48 48
48 48 52 52 52 52 52 52 52 52 48 48 48 48 48 48 48 48 48 48 48 48 48 56 56 56 56 48 48 48 52 48 48 48 48 48 48 52 48 48 48 48 52 48 48 52 48 48 48 48
48 48 52 52 52 52 48 48 48 48 48 48 48 52 48 48 52 52 52 52 48 48 52 52 48 48 48 48 48 48 48 48 48 48 48 48 48 48 48 48 52 48 52 52 48 52 52 48 48 48
48 52 52 52 52 52 52 52 48 48 48 48 48 48 48 48 48 52 48 48 48 48 48 48 48 48 48 48 48 48 48 48 48 48 48 52 48 48 48 52 48 48 48 48 52 48 52 52 48 48
48 48 52 52 48 52 52 52 48 48 48 48 48 48 48 52 48 48 48 48 48 52 52 52 48 48 48 48 48 48 48 52 48 48 48 48 48 48 48 52 52 48 52 48 48 48 48 48 48 48
48 48 52 52 52 48 52 48 48 48 48 48 48 48 48 52 56 56 56 56 56 56 56 56 56 56 56 56 56 56 56 56 56 56 48 48 48 48 48 48 48 48 52 52 48 48 48 48 48 48
48 48 52 52 52 52 52 48 48 48 48 48 52 48 48 48 56 43 43 43 43 43 43 43 43 43 43 43 43 43 43 43 43 56 52 48 48 48 48 48 48 48 48 48 48 48 48 48 48 48
16 48 52 48 48 48 48 48 48 48 48 48 48 48 48 48 48 48 48 48 48 48 48 48 42 42 48 48 48 48 48 48 48 48 48 48 52 48 48 52 48 48 48 48 48 50 50 50 50 16
16 16 48 48 48 48 48 48 48 48 48 48 48 48 48 48 48 48 16 16 16 16 16 16 42 42 16 16 16 16 16 16 48 48 48 48 48 48 48 48 48 48 48 48 48 50 50 50 16 16
16 16 16 16 16 48 48 48 48 48 48 48 48 48 48 48 48 48 16 48 48 48 48 48 42 42 48 48 48 48 48 16 48 48 48 48 48 48 48 48 48 48 48 48 48 16 16 16 16 16
84 84 84 84 16 48 48 48 48 48 48 48 48 48 48 48 48 48 16 48 48 48 48 48 42 42 48 48 48 48 48 16 48 48 48 48 48 48 48 48 48 48 48 48 48 16 86 86 86 86
84 84 84 84 48 48 48 48 48 48 48 48 48 48 48 48 48 48 16 48 48 48 48 48 42 42 48 48 48 48 48 16 48 48 48 48 48 48 48 48 48 48 48 48 48 50 86 86 86 86
84 0 0 41 41 41 41 41 41 41 41 41 41 41 41 41 41 41 16 41 41 41 41 41 42 42 41 41 41 41 41 16 41 41 41 41 41 41 41 41 41 41 41 41 41 43 43 2 2 86
84 0 0 48 48 48 48 48 48 48 48 48 48 48 48 48 48 48 16 48 48 48 48 48 42 42 48 48 48 48 48 16 48 48 48 48 48 48 48 48 48 48 48 48 48 50 50 2 2 86
84 0 0 48 48 48 48 48 48 48 48 48 48 48 48 48 48 48 16 48 48 48 48 48 42 42 48 48 48 48 48 16 48 48 48 48 48 48 48 48 48 48 48 48 48 50 50 2 2 86
84 0 0 41 41 41 41 41 41 41 41 41 41 41 41 41 41 41 16 41 41 41 41 41 42 42 41 41 41 41 41 16 41 41 41 41 41 41 41 41 41 41 41 41 41 43 43 2 2 86
84 60 0 48 48 48 48 48 48 48 48 48 48 48 48 48 48 48 16 48 48 48 48 48 42 42 48 48 48 48 48 16 48 48 48 48 48 48 48 48 48 48 48 48 48 50 50 2 2 86
84 0 0 48 48 48 48 48 48 48 48 48 48 48 48 48 48 48 16 48 48 48 48 48 42 42 48 48 48 48 48 16 48 48 48 48 48 48 48 48 48 48 48 48 48 50 50 2 62 86
84 0 0 41 41 41 41 41 41 41 41 41 41 41 41 41 41 41 16 41 41 41 41 41 42 42 41 41 41 41 41 16 41 41 41 41 41 41 41 41 41 41 41 41 41 43 43 2 2 86
84 0 0 48 48 48 48 48 48 48 48 48 48 48 48 48 48 48 16 48 48 48 48 48 42 42 48 48 48 48 48 16 48 48 48 48 48 48 48 48 48 48 48 48 48 50 50 2 2 86
84 0 0 48 48 48 48 48 48 48 48 48 48 48 48 48 48 48 16 48 48 48 48 48 42 42 48 48 48 48 48 16 48 48 48 48 48 48 48 48 48 48 48 48 48 50 50 2 2 86
84 0 0 41 41 41 41 41 41 41 41 41 41 41 41 41 41 41 16 41 41 41 41 41 42 42 41 41 41 41 41 16 41 41 41 41 41 41 41 41 41 41 41 41 41 43 43 2 2 86
84 84 84 84 48 48 48 48 48 48 48 48 48 48 48 48 48 48 16 48 48 48 48 48 42 42 48 48 48 48 48 16 48 48 48 48 48 48 48 48 48 48 48 48 48 50 86 86 86 86
84 84 84 84 16 48 48 48 48 48 48 48 48 48 48 48 48 48 16 48 48 48 48 48 42 42 48 48 48 48 48 16 48 48 48 48 48 48 48 48 48 48 48 48 48 16 86 86 86 86
16 16 16 16 16 48 48 48 48 48 48 48 48 48 48 48 48 48 16 48 48 48 48 48 42 42 48 48 48 48 48 16 48 48 48 48 48 48 48 48 48 48 48 48 48 16 16 16 16 16
16 16 48 48 48 48 48 48 48 48 48 52 52 48 52 48 48 52 16 16 16 16 16 16 42 42 16 16 16 16 16 16 48 52 48 48 48 48 48 48 48 48 48 48 48 50 50 50 16 16
16 48 48 48 48 48 48 48 48 48 52 48 52 48 48 48 48 52 48 48 48 48 48 48 42 42 52 48 52 48 48 48 48 52 48 48 48 48 48 48 48 48 48 48 48 50 50 54 50 16
48 48 48 48 48 52 48 48 48 48 48 48 48 48 48 48 48 43 43 43 43 43 43 43 43 43 43 43 43 43 43 43 43 48 52 48 52 48 48 48 48 48 52 52 52 52 52 52 48 48
48 48 52 48 48 48 48 48 48 48 48 48 48 48 48 48 52 56 56 56 56 56 56 56 56 56 56 56 56 56 56 56 56 52 52 52 48 48 48 48 48 48 48 52 52 52 52 52 48 48
48 48 52 48 52 48 48 48 48 52 48 52 48 52 52 48 52 52 52 48 48 48 48 48 48 52 48 52 48 52 52 48 52 52 52 48 48 48 48 48 48 48 48 52 52 52 48 52 48 48
48 48 48 48 48 48 48 48 48 48 52 48 48 48 48 48 52 52 52 52 52 48 48 48 48 48 52 48 48 48 48 48 52 52 52 52 48 52 52 48 48 48 48 48 52 52 52 52 48 48
48 48 48 48 48 48 48 48 48 52 48 48 48 52 48 48 48 48 52 48 48 48 48 48 48 52 48 48 48 52 48 48 48 48 52 48 48 48 48 48 48 48 48 48 48 52 52 48 48 48
48 48 48 48 48 48 48 48 48 48 48 48 48 48 52 48 48 48 48 48 48 48 48 56 56 56 56 48 48 48 52 48 48 48 48 48 48 52 48 48 48 48 52 48 48 48 48 48 48 48
48 48 48 48 48 48 48 48 48 48 48 48 48 48 48 48 48 48 48 48 48 48 48 56 56 56 56 48 48 48 48 48 48 48 48 48 48 48 52 48 48 48 48 48 48 48 48 48 48 48
48 48 48 48 48 48 48 48 48 48 48 48 48 48 48 48 48 48 48 48 48 48 48 56 56 56 56 48 48 48 48 48 48 48 48 48 48 48 48 48 48 48 48 48 48 48 48 48 48 48
48 48 48 48 48 48 48 48 48 48 48 48 48 48 48 48 48 48 48 48 48 48 48 56 56 56 56 48 48 48 48 48 48 48 48 48 48 48 48 48 48 48 48 48 48 48 48 48 48 48
48 48 48 48 48 48 48 48 48 48 48 48 48 48 48 48 48 48 48 48 48 48 48 56 56 56 56 48 48 48 48 48 48 48 48 48 48 48 48 48 48 48 48 48 48 48 48 48 48 48