84 84 84 84 84 84 84 84 84 84 84 84 84 84 84 84 84 84 84 84 84 84 84 84 84 84 84 84 84 84 84 84 84 84 84 84 84 84 84 84 84 84 84 16 60 16 84 84 84 84 84 84 84 84 84 84 84 84 84 84
84 84 65 65 65 65 65 65 65 65 65 65 65 65 65 65 65 65 65 65 65 65 65 65 65 65 65 65 84 84 84 84 65 65 65 65 65 65 65 65 65 65 65 16 0 16 84 65 65 65 65 65 65 65 65 65 65 65 84 84
84 66 4 4 4 4 4 4 4 4 4 4 4 4 4 4 4 4 4 4 4 4 4 4 4 4 4 4 64 84 84 66 0 0 0 0 0 0 0 0 0 0 0 16 0 16 0 0 0 0 0 0 0 0 0 0 0 0 64 84
84 66 4 4 4 4 4 4 4 4 4 4 4 4 4 4 4 4 4 4 4 4 4 4 4 4 4 4 64 84 84 66 0 0 0 0 0 0 0 0 0 0 0 16 0 16 0 0 0 0 0 0 0 0 0 0 0 0 64 84
84 66 4 4 4 4 4 4 4 4 4 4 4 4 4 4 4 4 4 4 4 4 4 4 4 4 4 4 64 84 84 66 0 0 0 0 0 0 0 0 0 0 0 16 0 16 0 0 0 0 0 0 0 0 0 0 0 0 64 84
84 66 4 4 4 4 4 4 4 4 4 4 4 4 4 4 4 4 4 4 4 4 4 4 4 4 4 16 64 84 84 66 56 0 0 0 0 0 0 0 0 0 0 16 0 16 0 0 0 0 0 0 0 0 0 0 0 0 64 84
84 66 4 4 4 4 4 4 4 4 4 4 4 4 4 4 4 4 4 4 4 4 4 4 4 4 4 41 41 41 41 41 41 0 0 0 0 0 0 0 0 0 0 16 0 16 0 0 0 0 0 0 0 0 0 0 0 0 64 84
84 66 4 4 4 4 4 56 37 56 37 56 4 4 4 4 4 4 56 37 56 37 56 4 4 4 4 16 64 84 84 66 56 0 0 0 0 16 37 16 37 16 0 16 4 16 0 0 16 37 16 37 16 0 0 0 0 0 64 84
84 66 4 4 4 4 4 56 56 56 56 56 4 4 4 4 4 4 56 56 56 56 56 4 4 4 4 4 64 84 84 66 0 0 0 0 0 16 16 16 16 16 0 16 4 16 0 0 16 16 16 16 16 0 0 0 0 0 64 84
84 66 4 4 4 4 4 56 4 4 4 56 56 56 4 4 56 56 56 4 4 4 56 4 4 4 4 4 64 84 84 66 0 0 0 0 0 0 0 0 0 0 0 16 4 16 0 0 0 0 0 0 0 0 0 0 0 0 64 84
84 66 4 4 4 4 4 56 4 4 4 4 4 4 4 4 4 4 4 4 4 4 56 4 4 4 4 4 64 84 84 66 0 0 0 0 0 0 0 0 0 0 0 0 0 0 0 0 0 0 0 0 0 0 0 0 0 0 64 84
84 66 4 4 4 4 4 56 56 56 4 4 4 4 4 4 4 4 4 4 56 56 56 4 4 4 4 4 64 84 84 66 0 0 0 0 0 0 0 0 0 0 0 0 0 0 0 0 0 0 0 0 0 0 0 0 0 0 64 84
84 66 4 4 4 4 4 4 0 56 4 4 4 4 4 4 4 4 4 4 56 4 4 4 4 4 4 4 64 84 84 66 0 0 0 0 0 0 0 0 0 0 0 0 4 0 0 0 0 0 0 0 0 0 0 0 0 0 64 84
84 66 4 4 4 4 4 4 4 56 4 4 4 4 4 4 4 4 4 4 4 4 4 4 4 4 4 16 64 84 84 66 56 0 0 0 0 0 0 0 0 0 0 0 4 0 0 0 0 0 0 0 0 0 0 0 0 0 64 84
84 66 4 4 4 4 4 4 4 4 4 4 4 4 0 0 4 4 4 4 4 4 4 4 4 4 4 41 41 41 41 41 41 0 0 0 0 0 0 16 16 16 16 16 16 16 16 16 16 16 16 0 0 0 0 0 0 0 64 84
84 66 4 4 4 4 4 4 4 4 4 4 4 4 60 0 4 4 4 4 4 4 4 4 4 4 4 41 41 41 41 41 41 0 0 0 0 0 0 0 0 0 0 0 4 0 0 0 0 0 0 0 0 0 0 0 0 0 64 84
84 66 4 4 4 4 4 4 4 56 4 4 4 4 4 4 4 4 4 4 4 4 4 4 4 4 4 16 64 84 84 66 56 0 0 0 0 0 0 0 0 0 0 0 0 0 0 0 0 0 0 0 0 0 0 0 0 0 64 84
84 66 4 4 4 4 4 4 4 56 4 4 4 4 4 4 4 4 4 4 56 4 4 4 4 4 4 4 64 84 84 66 0 0 0 0 0 0 0 0 0 0 0 0 0 0 0 0 0 0 0 0 0 0 0 0 0 0 64 84
84 66 4 4 4 4 4 56 56 56 4 4 4 4 4 4 4 4 4 4 56 56 56 4 4 4 4 4 64 84 84 66 0 0 0 0 0 0 0 0 0 0 0 0 0 0 0 0 0 0 0 0 0 0 0 0 0 0 64 84
84 66 4 4 4 4 4 56 4 4 4 4 4 4 4 4 4 4 4 4 4 4 56 4 4 4 4 4 64 84 84 66 0 0 0 0 0 0 0 0 0 0 0 0 0 0 0 0 0 0 0 0 0 0 0 0 0 0 64 84
84 66 4 4 4 4 4 56 4 4 4 56 56 56 4 4 56 56 56 4 4 4 56 4 4 4 4 4 64 84 84 66 0 0 0 0 0 0 0 0 0 0 0 16 0 16 0 0 0 0 0 0 0 0 0 0 0 0 64 84
84 66 4 4 4 4 4 56 56 56 56 56 4 4 4 4 4 4 56 56 56 56 56 4 4 4 4 4 64 84 84 66 0 0 0 0 0 16 16 16 16 16 0 16 0 16 0 0 16 16 16 16 16 0 0 0 0 0 64 84
84 66 0 4 4 4 4 56 39 56 39 56 4 4 4 4 4 4 56 39 56 39 56 4 4 4 4 16 64 84 84 66 56 0 0 0 0 16 39 16 39 16 0 16 0 16 0 0 16 39 16 39 16 0 0 0 0 0 64 84
84 66 0 4 4 4 4 4 4 4 4 4 4 4 4 4 4 4 4 4 4 4 4 4 4 4 4 41 41 41 41 41 41 0 0 0 0 0 0 0 0 0 0 16 0 16 0 0 0 0 0 0 0 0 0 0 0 0 64 84
84 66 4 4 4 4 4 4 4 4 4 4 4 4 4 4 4 4 4 4 4 4 4 4 4 4 4 16 64 84 84 66 56 0 0 0 0 0 0 0 0 0 0 16 0 16 0 0 0 0 0 0 0 0 0 0 0 0 64 84
84 66 4 4 4 4 4 4 4 4 4 4 4 4 4 4 4 4 4 4 4 4 4 4 4 0 4 4 64 84 84 66 0 0 0 0 0 0 0 0 0 0 0 16 0 16 0 0 0 0 0 0 0 0 0 0 0 0 64 84
84 66 4 4 4 4 4 4 4 4 4 4 4 4 4 4 4 4 4 4 4 4 4 4 4 4 4 4 64 84 84 66 0 0 0 0 0 0 0 0 0 0 0 16 0 16 0 0 0 0 0 0 0 0 0 0 0 0 64 84
84 66 4 4 4 4 4 4 4 4 4 4 4 4 4 4 4 4 4 4 4 4 4 4 4 4 4 4 64 84 84 66 0 0 0 0 0 0 0 0 0 0 0 16 0 16 0 0 0 0 0 0 0 0 0 0 0 0 64 84
84 84 67 67 67 67 67 67 67 67 67 67 67 67 67 67 67 67 67 67 67 67 67 67 67 67 67 67 84 84 84 84 67 67 67 67 67 67 67 67 67 67 67 16 0 16 67 67 67 67 67 67 67 67 67 67 67 67 84 84
84 84 84 84 84 84 84 84 84 84 84 84 84 84 84 84 84 84 84 84 84 84 84 84 84 84 84 84 84 84 84 84 84 84 84 84 84 84 84 84 84 84 84 16 60 16 84 84 84 84 84 84 84 84 84 84 84 84 84 84