56 56 56 56 56 56 56 56 0 0 56 56 56 56 56 56 56 56
56 56 60 0 0 0 0 56 0 0 56 0 0 0 0 60 56 56
56 56 84 84 84 56 0 56 0 0 56 0 56 85 85 84 56 56
56 39 56 56 56 56 0 56 0 0 56 0 56 56 56 56 39 56
56 0 0 0 0 0 0 56 0 0 56 0 0 0 0 0 0 56
56 0 56 56 56 56 56 56 0 0 56 56 56 56 56 56 0 56
56 0 56 0 0 0 0 56 0 0 56 0 0 0 0 56 0 56
56 0 0 0 0 0 0 0 0 0 0 0 0 0 0 0 0 56
56 56 56 56 56 56 56 0 0 0 0 56 56 56 56 56 56 56
56 36 84 84 0 0 0 0 0 0 0 0 0 0 86 84 38 56
56 36 84 84 0 0 0 0 0 0 0 0 0 0 85 87 38 56
56 36 84 84 0 0 0 0 0 0 0 0 0 0 84 84 38 56
56 84 84 84 0 0 0 0 0 0 0 0 0 0 84 84 84 56
56 84 84 84 0 0 0 0 0 0 0 0 0 0 84 84 84 56
56 56 56 56 56 56 56 56 56 56 56 56 56 56 56 56 56 56