39 39 12 39 12 39 76 72 72 72 72 72 72 72 72 72 72 72 72 72 0 0 0 0 0 0 0 0 0 16 39 12 39 39 12
12 12 12 12 12 12 76 72 72 72 72 72 72 72 72 76 72 72 72 72 0 0 0 16 0 0 16 0 0 16 12 12 12 12 12
12 12 12 12 12 12 76 72 72 72 76 72 72 72 72 72 72 72 72 72 0 0 0 0 0 0 0 0 0 16 12 12 12 12 12
12 12 12 12 12 12 76 72 72 72 72 72 72 72 72 72 72 72 72 72 0 0 0 0 16 0 0 0 0 16 12 12 12 12 38
72 72 72 72 72 72 72 72 72 72 72 76 72 72 72 72 72 72 72 72 0 0 0 16 0 0 16 0 0 16 0 0 16 16 16
76 76 76 72 76 76 76 72 72 72 72 72 72 72 72 72 72 72 72 72 0 0 0 0 0 0 0 0 0 0 0 0 0 0 0
72 72 72 72 72 72 76 72 72 72 72 72 76 72 72 72 72 72 72 72 0 0 0 0 16 0 0 0 0 16 16 16 0 16 16
72 72 72 72 72 72 76 72 72 76 72 72 72 72 72 72 72 72 72 72 0 0 16 0 0 0 16 0 0 0 0 0 0 0 0
72 72 72 72 72 72 72 72 72 72 72 72 72 72 72 72 72 72 72 72 0 0 0 0 0 0 0 0 0 16 16 16 0 0 0
72 72 72 72 72 72 76 72 72 72 72 72 76 72 72 72 72 72 72 72 0 0 0 0 0 0 0 0 0 0 0 0 0 16 0
72 72 72 72 72 72 76 72 72 72 72 72 72 72 72 72 72 72 72 72 0 0 0 0 0 0 0 0 0 0 0 0 0 16 0
24 24 24 24 24 24 24 24 24 24 24 24 24 24 52 52 24 24 24 24 84 84 84 84 84 84 84 84 84 84 84 42 42 84 84
24 24 24 24 24 24 24 24 24 24 24 24 24 24 52 52 24 24 24 24 84 84 84 16 84 84 84 84 84 84 84 42 42 16 84
24 24 24 24 24 24 24 24 24 24 24 24 24 24 52 52 24 24 24 24 84 84 84 84 84 84 84 84 84 84 84 42 42 84 84
24 24 24 24 24 24 48 48 48 48 52 52 52 52 52 52 52 52 24 24 84 16 84 84 84 16 84 84 84 84 84 42 42 84 84
56 56 56 56 56 56 48 48 48 48 52 52 52 52 56 52 52 52 24 24 84 84 84 16 84 84 84 84 16 16 16 42 42 16 16
36 12 12 12 12 48 48 48 48 48 56 52 52 52 52 52 52 52 24 24 84 84 84 84 84 84 84 84 16 12 39 12 12 39 12
36 12 12 12 12 56 48 48 56 48 52 52 52 56 52 52 52 52 48 48 41 41 41 41 41 41 41 41 41 12 12 12 12 12 12
36 12 12 12 12 56 48 48 48 48 52 52 52 52 52 56 52 52 48 48 41 41 41 41 41 41 41 41 41 12 12 12 12 12 12
36 12 12 12 12 48 48 48 48 48 56 52 52 52 52 52 52 52 24 24 84 84 84 84 16 84 84 84 16 36 12 12 12 12 12