36 12 60 12 48 52 48 52 48 52 16 39 16 39 16 39 16 39 16 39
16 12 16 16 52 48 52 48 52 48 15 15 15 15 15 15 15 15 15 15
36 12 12 16 48 52 48 52 48 52 15 15 15 15 15 15 15 15 16 60
16 12 12 48 52 48 52 48 52 48 52 48 52 48 52 48 52 16 16 15
36 12 12 52 48 52 48 52 48 52 48 52 48 52 48 52 48 52 48 52
16 12 12 48 52 48 52 48 52 48 52 48 52 48 52 48 52 48 52 48
36 12 12 52 48 52 48 52 48 52 48 52 48 52 48 52 48 52 48 52
16 12 12 48 52 48 52 48 52 48 52 48 52 48 52 48 52 48 52 48
36 12 12 52 48 52 48 52 48 52 48 52 48 52 48 52 48 52 48 52
16 12 12 48 52 48 52 48 52 48 52 48 52 48 52 48 52 48 52 48
48 52 48 52 48 52 48 52 48 52 48 52 48 52 48 52 48 14 14 16
52 48 52 48 52 48 52 48 52 48 52 48 52 48 52 48 52 14 14 38
48 52 48 52 48 52 48 52 48 52 48 52 48 52 48 52 48 14 14 16
52 48 52 48 52 48 52 48 52 48 52 48 52 48 52 48 52 14 14 38
48 52 48 52 48 52 48 52 48 52 48 52 48 52 48 52 48 14 14 16
52 48 52 48 52 48 52 48 52 48 52 48 52 48 52 48 52 14 14 38
13 16 16 52 48 52 48 52 48 52 48 52 48 52 48 52 48 14 14 16
60 16 13 13 13 13 13 13 13 13 52 48 52 48 52 48 16 14 14 38
13 13 13 13 13 13 13 13 13 13 48 52 48 52 48 52 16 16 14 16
37 16 37 16 37 16 37 16 37 16 52 48 52 48 52 48 14 60 14 38