12 12 12 12 12 12 12 12 12 12 12 12 12 12 12 12 12 12 12 12 12 12 12 12 12 12 12 12 12 12 12 12 12 12 12 12 12 12 12 12
12 24 24 24 24 27 27 27 27 27 27 27 27 27 27 27 27 27 27 27 27 27 27 27 27 27 27 27 27 27 27 27 27 27 27 27 27 27 27 12
12 24 24 24 24 24 27 27 27 27 27 27 27 27 27 27 27 27 27 27 27 27 27 27 27 27 27 27 27 27 27 27 27 27 27 27 27 27 27 12
12 24 24 24 24 24 27 27 27 27 27 27 27 27 27 27 27 27 27 27 27 27 27 27 27 27 27 27 27 27 27 27 27 27 27 27 27 27 27 12
12 24 24 24 24 29 29 29 29 29 29 29 29 29 29 29 29 29 29 29 29 29 29 29 29 29 29 29 29 29 29 29 29 29 29 27 27 27 27 12
12 24 24 24 30 0 2 0 0 2 2 2 2 0 3 1 0 1 3 0 2 3 0 3 2 3 2 3 1 3 0 1 0 0 0 28 26 26 26 12
12 24 24 24 30 0 14 37 37 13 13 13 37 37 13 13 13 37 37 13 13 37 37 13 13 13 37 37 13 13 13 37 37 13 2 28 26 26 26 12
12 24 24 24 30 3 38 56 56 3 0 0 16 16 2 0 3 56 56 2 3 16 16 0 2 0 56 56 0 2 2 16 16 36 1 28 26 26 26 12
12 24 24 24 30 0 38 56 0 0 1 3 0 1 1 1 3 0 1 2 3 3 1 3 1 2 1 0 0 2 3 1 16 36 3 28 26 26 26 12
12 24 24 24 30 1 14 2 2 1 0 1 1 0 0 2 0 1 3 1 3 3 3 2 2 3 0 3 3 0 0 3 2 12 0 28 26 26 26 12
12 24 24 24 30 2 14 0 2 3 3 3 1 3 3 3 1 0 1 3 0 3 1 1 0 0 2 3 0 1 3 2 1 12 2 28 26 26 26 12
12 24 24 24 30 1 14 3 3 0 3 1 0 1 3 2 2 2 1 2 1 1 3 2 3 0 1 1 1 2 3 2 1 12 1 28 26 26 26 12
12 24 24 24 30 0 38 16 2 1 1 1 0 0 0 2 1 3 3 2 0 0 3 2 3 3 0 1 3 3 2 3 56 36 1 28 26 26 26 12
12 24 24 24 30 1 38 16 1 2 2 2 2 0 3 2 2 3 0 3 1 2 0 3 3 2 1 1 1 3 1 1 56 36 2 28 26 26 26 12
12 24 24 24 30 1 14 2 0 3 1 2 2 3 1 0 3 3 0 0 2 3 3 2 1 1 0 1 2 0 3 0 2 12 0 28 26 26 26 12
12 24 24 24 30 0 14 2 2 0 2 3 0 2 0 2 2 0 0 1 0 3 3 3 0 1 0 2 3 0 2 1 2 12 3 28 26 26 26 12
12 24 24 24 30 1 38 56 3 0 1 1 3 2 3 0 1 3 2 3 3 2 1 1 0 0 2 1 2 2 0 1 16 36 1 28 26 26 26 12
12 24 24 24 30 0 38 56 3 1 1 1 3 0 1 0 1 1 1 2 2 2 2 1 2 3 3 2 1 1 1 3 16 36 3 28 26 26 26 12
12 24 24 24 30 3 14 2 2 0 3 1 2 2 0 3 2 1 0 0 1 3 1 3 3 3 1 3 2 1 3 0 0 12 1 28 26 26 26 12
12 24 24 24 30 0 14 3 0 2 3 3 3 0 3 2 3 2 0 0 0 3 1 0 0 0 1 3 0 0 2 1 0 12 3 28 26 26 26 12
12 24 24 24 30 1 14 2 0 1 0 2 1 1 2 1 2 1 2 0 3 2 2 0 1 2 1 1 3 0 3 0 3 12 3 28 26 26 26 12
12 24 24 24 30 3 38 16 3 1 0 2 2 3 0 3 1 3 1 1 0 3 2 1 3 3 3 2 1 3 2 2 56 36 1 28 26 26 26 12
12 24 24 24 30 1 38 16 16 0 0 2 56 56 2 0 2 16 16 1 0 56 56 1 2 0 16 16 2 2 1 56 56 36 2 28 26 26 26 12
12 24 24 24 30 3 15 39 39 15 15 15 39 39 15 15 15 39 39 15 15 39 39 15 15 15 39 39 15 15 15 39 39 12 1 28 26 26 26 12
12 24 24 24 30 1 0 1 3 2 0 2 2 1 2 0 3 0 1 0 0 3 2 0 2 1 0 0 2 2 0 0 3 0 2 28 26 26 26 12
12 24 24 24 25 31 31 31 31 31 31 31 31 31 31 31 31 31 31 31 31 31 31 31 31 31 31 31 31 31 31 31 31 31 31 27 27 27 27 12
12 24 24 24 25 25 25 25 25 25 25 25 25 25 25 25 25 25 25 25 25 25 25 25 25 25 25 25 25 25 25 25 25 25 25 27 27 27 27 12
12 24 24 24 25 25 25 25 25 25 25 25 25 25 25 25 25 25 25 25 25 25 25 25 25 25 25 25 25 25 25 25 25 25 25 27 27 27 27 12
12 24 24 25 25 25 25 25 25 25 25 25 25 25 25 25 25 25 25 25 25 25 25 25 25 25 25 25 25 25 25 25 25 25 25 27 27 27 27 12
12 12 12 12 12 12 12 12 12 12 12 12 12 12 12 12 12 12 12 12 12 12 12 12 12 12 12 12 12 12 12 12 12 12 12 12 12 12 12 12