41 41 41 41 41 41 41 41 41 41 41 41 41 41 41 41 41 41 41 41 41 41 41 41 41 41 41 41 41 41 41 41 41 41 41 41 41 41 41 41 41 41 41 41 41 41 41 41 41 41
36 24 24 24 24 24 24 24 24 24 24 24 24 24 24 24 24 24 24 24 24 24 16 24 24 24 24 16 24 24 24 24 24 24 24 24 24 24 24 24 24 24 24 24 24 24 24 24 24 24
16 24 24 24 24 24 24 24 24 24 24 24 24 24 24 24 24 24 24 24 24 24 24 24 24 24 24 24 24 24 24 24 24 24 24 24 24 24 24 24 24 24 24 24 24 24 24 24 24 24
36 24 24 24 24 24 24 24 24 24 24 24 24 24 24 16 24 24 24 24 24 24 24 24 24 24 24 24 24 24 24 24 24 24 16 24 24 24 24 24 24 24 24 24 24 24 24 24 24 24
41 41 41 41 41 41 41 41 41 41 41 41 41 41 41 41 41 41 41 41 41 41 41 41 41 41 41 41 41 41 41 41 41 41 41 41 41 41 41 41 41 41 41 38 41 38 41 38 41 38
24 24 24 24 24 24 24 24 24 24 24 24 24 24 24 24 24 24 24 24 24 24 24 16 24 24 16 24 24 24 24 24 24 24 24 24 24 24 24 24 24 24 24 24 24 24 24 24 24 24
24 24 24 24 24 24 24 24 24 24 24 24 24 24 24 24 24 16 24 24 24 24 24 24 24 24 24 24 24 24 24 24 16 24 24 24 24 24 24 24 24 24 24 24 24 24 24 24 24 24
36 41 36 41 36 41 36 41 36 41 41 41 41 41 41 41 41 41 41 41 41 41 41 41 41 41 41 41 41 41 41 41 41 41 41 41 41 41 41 41 41 41 41 41 41 41 41 41 41 38
16 24 24 24 24 24 24 24 24 24 24 24 24 24 24 24 24 24 24 24 16 24 24 24 16 16 24 24 24 16 24 24 24 24 24 24 24 24 24 24 24 24 24 24 24 24 24 24 24 16
36 24 24 84 84 84 84 84 84 84 84 16 84 84 84 84 84 84 84 84 84 16 84 84 84 84 84 84 16 84 84 84 84 84 84 84 84 84 16 84 84 84 84 84 84 84 84 24 24 38
16 36 24 84 84 84 84 84 84 60 84 84 84 84 84 84 84 84 84 84 84 84 84 84 84 84 84 84 84 84 84 84 84 84 84 84 84 84 84 84 60 84 84 84 84 84 84 24 38 16
36 24 24 84 84 84 84 84 84 84 84 16 84 84 84 84 84 84 84 84 84 16 84 84 84 84 84 84 16 84 84 84 84 84 84 84 84 84 16 84 84 84 84 84 84 84 84 24 24 38
16 24 24 24 24 24 24 24 24 24 24 24 24 24 24 24 24 24 24 24 16 24 24 24 16 16 24 24 24 16 24 24 24 24 24 24 24 24 24 24 24 24 24 24 24 24 24 24 24 16
36 41 41 41 41 41 41 41 41 41 41 41 41 41 41 41 41 41 41 41 41 41 41 41 41 41 41 41 41 41 41 41 41 41 41 41 41 41 41 41 41 38 41 38 41 38 41 38 41 38
24 24 24 24 24 24 24 24 24 24 24 24 24 24 24 24 24 16 24 24 24 24 24 24 24 24 24 24 24 24 24 24 16 24 24 24 24 24 24 24 24 24 24 24 24 24 24 24 24 24
24 24 24 24 24 24 24 24 24 24 24 24 24 24 24 24 24 24 24 24 24 24 24 16 24 24 16 24 24 24 24 24 24 24 24 24 24 24 24 24 24 24 24 24 24 24 24 24 24 24
36 41 36 41 36 41 36 41 41 41 41 41 41 41 41 41 41 41 41 41 41 41 41 41 41 41 41 41 41 41 41 41 41 41 41 41 41 41 41 41 41 41 41 41 41 41 41 41 41 41
24 24 24 24 24 24 24 24 24 24 24 24 24 24 24 16 24 24 24 24 24 24 24 24 24 24 24 24 24 24 24 24 24 24 16 24 24 24 24 24 24 24 24 24 24 24 24 24 24 38
24 24 24 24 24 24 24 24 24 24 24 24 24 24 24 24 24 24 24 24 24 24 24 24 24 24 24 24 24 24 24 24 24 24 24 24 24 24 24 24 24 24 24 24 24 24 24 24 24 16
24 24 24 24 24 24 24 24 24 24 24 24 24 24 24 24 24 24 24 24 24 16 24 24 24 24 24 24 16 24 24 24 24 24 24 24 24 24 24 24 24 24 24 24 24 24 24 24 24 38
41 41 41 41 41 41 41 41 41 41 41 41 41 41 41 41 41 41 41 41 41 41 41 41 41 41 41 41 41 41 41 41 41 41 41 41 41 41 41 41 41 41 41 41 41 41 41 41 41 41