56 56 24 24 24 24 24 24 24 24 24 24 24 24 24 24 24 24 24 24 24 24 24 24 24 24 24 24 24 24 24 24 24 24 24 24 24 24 24 24 24 24 26 26 26 26 26 26 56 56
36 12 24 24 24 24 24 24 24 24 24 24 24 24 24 24 24 24 24 24 24 24 24 24 24 24 24 24 24 24 24 24 24 24 24 24 24 24 24 24 24 24 26 26 26 26 26 26 14 38
56 12 24 24 24 24 24 24 24 24 24 24 24 24 24 24 24 24 24 24 24 24 24 24 24 24 24 24 24 24 24 24 24 24 24 24 24 24 24 24 24 24 26 26 26 26 26 26 14 56
36 12 24 24 24 24 24 24 24 24 24 24 24 24 24 24 24 24 24 24 24 24 24 24 24 24 24 24 24 24 24 24 24 24 24 24 24 24 24 24 24 24 26 26 26 26 26 26 14 38
56 12 24 24 24 24 24 24 24 24 24 16 16 16 16 16 16 24 24 24 24 24 16 16 16 16 16 16 24 24 24 24 24 16 16 16 16 16 16 24 24 24 26 26 26 26 26 26 14 56
36 12 24 24 24 24 24 24 24 24 24 16 16 16 16 16 16 24 24 24 24 24 16 16 16 16 16 16 24 24 24 24 24 16 16 16 16 16 16 24 24 24 26 26 26 26 26 26 14 38
56 12 24 24 24 24 24 24 24 24 24 16 16 16 16 16 16 24 24 24 24 24 16 16 16 16 16 16 24 24 24 24 24 16 16 16 16 16 16 24 24 24 26 26 26 26 26 26 14 56
36 12 24 24 24 24 24 24 24 24 24 16 16 16 16 16 16 24 24 24 24 24 16 16 16 16 16 16 24 24 24 24 24 16 16 16 16 16 16 24 24 24 26 26 26 26 26 26 14 38
56 12 24 24 24 24 24 24 24 24 24 16 16 16 16 16 16 24 24 24 24 24 16 16 16 16 16 16 24 24 24 24 24 16 16 16 16 16 16 24 24 24 26 26 26 26 26 26 14 56
36 12 24 24 24 24 24 24 24 24 24 24 24 24 24 24 24 24 24 24 24 24 24 24 24 24 24 24 24 24 24 24 24 24 24 24 24 24 24 24 24 24 26 26 26 26 26 26 14 38
56 12 24 24 24 24 24 24 24 24 24 24 24 24 24 24 24 24 24 24 24 24 24 24 24 24 24 24 24 24 24 24 24 24 24 24 24 24 24 24 24 24 26 26 26 26 26 26 14 56
56 56 56 56 56 24 24 24 24 24 24 24 24 24 24 24 24 24 24 24 24 24 24 24 24 24 24 24 24 24 24 24 24 24 24 24 24 24 24 24 24 24 26 26 26 56 56 56 56 56
56 24 24 24 24 24 24 24 24 24 24 24 24 24 24 24 24 24 24 24 24 24 24 24 24 24 24 24 24 24 24 24 24 24 24 24 24 24 24 24 24 24 26 26 26 26 26 26 26 56
56 24 24 24 24 24 24 24 24 24 24 16 16 16 16 16 16 24 24 24 24 24 16 16 16 16 16 16 24 24 24 24 24 16 16 16 16 16 16 24 24 24 26 26 26 26 26 26 26 56
56 56 24 24 24 24 24 24 24 24 24 16 16 16 16 16 16 24 24 24 24 24 16 16 16 16 16 16 24 24 24 24 24 16 16 16 16 16 16 24 24 24 26 26 26 26 24 24 56 56
56 56 56 56 24 24 24 24 24 24 24 16 16 16 16 16 16 24 24 24 24 24 16 16 16 16 16 16 24 24 24 24 24 16 16 16 16 16 16 24 24 24 56 56 26 26 56 56 56 56
0 0 0 56 24 24 56 56 24 24 24 16 16 16 16 16 16 24 24 24 24 24 16 16 16 16 16 16 24 24 24 24 24 16 16 16 16 16 16 24 24 24 56 56 26 26 56 2 2 2
0 0 0 0 28 24 56 56 24 24 24 16 16 16 16 16 16 24 24 24 24 24 16 16 16 16 16 16 24 24 24 24 24 16 16 16 16 16 16 24 24 24 26 56 26 30 2 2 2 2
0 0 0 0 28 24 56 24 24 24 24 24 24 24 24 24 24 24 24 24 24 24 24 24 24 24 24 24 24 24 24 24 24 24 24 24 24 24 24 24 24 24 26 56 26 30 2 2 2 2
0 0 0 0 28 24 56 24 24 24 24 24 24 24 24 24 24 24 24 24 24 24 24 24 24 24 24 24 24 24 24 24 24 24 24 24 24 24 24 24 24 24 26 56 26 30 2 2 2 62
60 0 0 0 28 24 56 24 24 24 24 24 24 24 24 24 24 24 24 24 24 24 24 24 24 24 24 24 24 24 24 24 24 24 24 24 24 24 24 24 24 24 26 56 26 30 2 2 2 2
0 0 0 0 28 24 56 24 24 24 24 24 24 24 24 24 24 24 24 24 24 24 24 24 24 24 24 24 24 24 24 24 24 24 24 24 24 24 24 24 24 24 26 56 26 30 2 2 2 2
0 0 0 0 28 24 56 24 24 24 24 16 16 16 16 16 16 24 24 24 24 24 16 16 16 16 16 16 24 24 24 24 24 16 16 16 16 16 16 24 24 24 56 56 26 30 2 2 2 2
0 0 0 56 24 24 56 56 24 24 24 16 16 16 16 16 16 24 24 24 24 24 16 16 16 16 16 16 24 24 24 24 24 16 16 16 16 16 16 24 24 24 56 56 26 26 56 2 2 2
56 56 56 56 24 24 56 56 24 24 24 16 16 16 16 16 16 24 24 24 24 24 16 16 16 16 16 16 24 24 24 24 24 16 16 16 16 16 16 24 24 24 26 26 26 26 56 56 56 56
56 56 26 26 24 24 24 24 24 24 24 16 16 16 16 16 16 24 24 24 24 24 16 16 16 16 16 16 24 24 24 24 24 16 16 16 16 16 16 24 24 24 26 26 26 26 26 26 56 56
56 24 24 24 24 24 24 24 24 24 24 16 16 16 16 16 16 24 24 24 24 24 16 16 16 16 16 16 24 24 24 24 24 16 16 16 16 16 16 24 24 24 26 26 26 26 26 26 26 56
56 24 24 24 24 24 24 24 24 24 24 24 24 24 24 24 24 24 24 24 24 24 24 24 24 24 24 24 24 24 24 24 24 24 24 24 24 24 24 24 24 24 26 26 26 26 26 26 26 56
56 56 56 56 56 24 24 24 24 24 24 24 24 24 24 24 24 24 24 24 24 24 24 24 24 24 24 24 24 24 24 24 24 24 24 24 24 24 24 24 24 24 26 26 26 56 56 56 56 56
56 12 24 24 24 24 24 24 24 24 24 24 24 24 24 24 24 24 24 24 24 24 24 24 24 24 24 24 24 24 24 24 24 24 24 24 24 24 24 24 24 24 26 26 26 26 26 26 14 56
36 12 24 24 24 24 24 24 24 24 24 24 24 24 24 24 24 24 24 24 24 24 24 24 24 24 24 24 24 24 24 24 24 24 24 24 24 24 24 24 24 24 26 26 26 26 26 26 14 38
56 12 24 24 24 24 24 24 24 24 24 16 16 16 16 16 16 24 24 24 24 24 16 16 16 16 16 16 24 24 24 24 24 16 16 16 16 16 16 24 24 24 26 26 26 26 26 26 14 56
36 12 24 24 24 24 24 24 24 24 24 16 16 16 16 16 16 24 24 24 24 24 16 16 16 16 16 16 24 24 24 24 24 16 16 16 16 16 16 24 24 24 26 26 26 26 26 26 14 38
56 12 24 24 24 24 24 24 24 24 24 16 16 16 16 16 16 24 24 24 24 24 16 16 16 16 16 16 24 24 24 24 24 16 16 16 16 16 16 24 24 24 26 26 26 26 26 26 14 56
36 12 24 24 24 24 24 24 24 24 24 16 16 16 16 16 16 24 24 24 24 24 16 16 16 16 16 16 24 24 24 24 24 16 16 16 16 16 16 24 24 24 26 26 26 26 26 26 14 38
56 12 24 24 24 24 24 24 24 24 24 16 16 16 16 16 16 24 24 24 24 24 16 16 16 16 16 16 24 24 24 24 24 16 16 16 16 16 16 24 24 24 26 26 26 26 26 26 14 56
36 12 24 24 24 24 24 24 24 24 24 24 24 24 24 24 24 24 24 24 24 24 24 24 24 24 24 24 24 24 24 24 24 24 24 24 24 24 24 24 24 24 26 26 26 26 26 26 14 38
56 12 24 24 24 24 24 24 24 24 24 24 24 24 24 24 24 24 24 24 24 24 24 24 24 24 24 24 24 24 24 24 24 24 24 24 24 24 24 24 24 24 26 26 26 26 26 26 14 56
36 12 24 24 24 24 24 24 24 24 24 24 24 24 24 24 24 24 24 24 24 24 24 24 24 24 24 24 24 24 24 24 24 24 24 24 24 24 24 24 24 24 26 26 26 26 26 26 14 38
56 56 24 24 24 24 24 24 24 24 24 24 24 24 24 24 24 24 24 24 24 24 24 24 24 24 24 24 24 24 24 24 24 24 24 24 24 24 24 24 24 24 26 26 26 26 26 26 56 56