16 16 0 0 0 0 0 0 0 0 0 0 0 0 0 0 0 0 83 72 72 72 72 72 72 72 72 72 72 72 72 72 72 72 72 72 72 72 76 76
36 12 0 0 0 0 0 0 0 0 0 0 0 0 0 0 0 0 0 83 72 72 72 72 72 72 72 72 72 72 72 72 72 72 72 72 72 72 14 38
16 16 0 0 0 0 0 0 0 0 0 0 0 0 0 0 0 0 0 0 83 72 72 72 72 72 72 72 72 72 72 72 72 72 72 72 72 72 76 76
16 16 0 0 0 0 0 0 0 0 0 0 0 0 0 0 0 0 0 0 82 72 72 72 72 72 72 72 72 72 72 72 72 72 72 72 72 72 76 76
36 12 0 0 0 0 0 0 0 0 0 0 0 0 0 0 0 0 0 0 83 72 72 72 72 72 72 72 72 72 72 72 72 72 72 72 72 72 14 38
16 16 0 0 0 16 0 0 0 0 16 0 0 0 0 0 0 0 0 0 0 83 72 72 72 72 72 72 72 72 72 72 72 72 72 72 72 72 76 76
16 16 0 0 16 16 0 82 81 0 16 16 0 0 0 0 0 0 0 0 0 0 83 72 72 72 72 72 72 72 72 72 72 72 72 72 72 72 76 76
36 12 0 0 0 0 82 72 72 81 0 0 0 0 0 0 0 0 0 0 0 0 0 83 72 72 72 72 72 72 72 72 72 72 72 72 72 72 14 38
16 16 0 0 0 82 72 60 12 72 81 0 0 0 0 0 0 0 0 0 0 0 0 82 72 72 72 72 72 72 72 72 72 72 72 72 72 72 76 76
16 16 0 0 0 83 72 12 12 72 80 0 0 0 0 0 0 0 0 0 0 0 0 83 72 72 72 72 72 72 72 72 72 72 72 72 72 72 76 76
36 12 0 0 0 0 83 72 72 80 0 0 0 0 0 0 0 0 0 0 0 0 0 82 72 72 72 72 72 72 72 72 72 72 72 72 72 72 14 38
16 16 0 0 16 16 0 83 80 0 16 16 0 0 0 0 0 0 0 0 0 0 0 83 72 72 72 72 72 72 72 72 72 72 72 72 72 72 76 76
16 16 0 0 0 16 0 0 0 0 16 0 0 0 0 0 0 0 0 0 0 0 0 82 72 72 72 72 72 72 72 72 72 72 72 72 72 72 76 76
36 12 0 0 0 0 0 0 0 0 0 0 0 0 0 0 0 0 0 0 0 0 82 72 72 72 72 72 72 72 72 72 72 72 72 72 72 72 14 38
16 16 0 0 0 0 0 0 0 0 0 0 0 0 0 0 0 0 0 0 0 0 83 72 72 72 72 72 72 72 72 72 72 72 72 72 72 72 76 76
16 16 0 0 0 0 0 0 0 0 0 0 0 0 0 0 0 0 0 0 0 0 82 72 72 72 72 72 72 72 72 72 72 72 72 72 72 72 76 76
36 12 0 0 0 0 0 0 0 0 0 0 0 0 0 0 0 0 0 0 0 82 72 72 72 72 72 72 72 72 72 72 72 72 72 72 72 72 14 38
16 16 0 0 0 0 0 0 0 0 0 0 0 0 0 0 0 0 0 0 82 72 72 72 72 72 72 72 72 72 72 72 72 72 72 72 72 72 76 76
16 16 0 0 0 0 0 0 0 0 0 0 0 0 0 0 0 0 0 82 72 72 72 72 72 72 72 72 72 72 72 72 72 72 72 72 72 72 76 76
36 12 0 0 0 0 0 0 0 0 0 0 0 0 0 0 0 0 0 83 72 72 72 72 72 72 72 72 72 72 72 72 72 72 72 72 72 72 14 38
16 16 0 0 0 0 0 0 0 0 0 0 0 0 0 0 0 0 0 82 72 72 72 72 72 72 72 72 72 72 72 72 72 72 72 72 72 72 76 76
16 16 0 0 0 0 0 0 0 0 0 0 0 0 0 0 0 0 82 72 72 72 72 72 72 72 72 72 72 72 72 72 72 72 72 72 72 72 76 76
36 12 0 0 0 0 0 0 0 0 0 0 0 0 0 0 0 82 72 72 72 72 72 72 72 72 72 72 72 72 72 72 72 72 72 72 72 72 14 38
16 16 0 0 0 0 0 0 0 0 0 0 0 0 0 0 0 83 72 72 72 72 72 72 72 72 72 72 72 72 72 72 72 72 72 72 72 72 76 76
16 16 0 0 0 0 0 0 0 0 0 0 0 0 0 0 0 82 72 72 72 72 72 72 72 72 72 72 72 72 72 72 72 72 72 72 72 72 76 76
36 12 0 0 0 0 0 0 0 0 0 0 0 0 0 0 82 72 72 72 72 72 72 72 72 72 72 72 72 72 72 72 72 72 72 72 72 72 14 38
16 16 0 0 0 0 0 0 0 0 0 0 0 0 0 82 72 72 72 72 72 72 72 72 72 72 72 72 72 76 72 72 72 72 76 72 72 72 76 76
16 16 0 0 0 0 0 0 0 0 0 0 0 0 82 72 72 72 72 72 72 72 72 72 72 72 72 72 76 76 72 80 83 72 76 76 72 72 76 76
36 12 0 0 0 0 0 0 0 0 0 0 0 0 83 72 72 72 72 72 72 72 72 72 72 72 72 72 72 72 80 0 0 83 72 72 72 72 14 38
16 16 0 0 0 0 0 0 0 0 0 0 0 0 82 72 72 72 72 72 72 72 72 72 72 72 72 72 72 80 0 12 12 0 83 72 72 72 76 76
16 16 0 0 0 0 0 0 0 0 0 0 0 0 83 72 72 72 72 72 72 72 72 72 72 72 72 72 72 81 0 12 60 0 82 72 72 72 76 76
36 12 0 0 0 0 0 0 0 0 0 0 0 0 82 72 72 72 72 72 72 72 72 72 72 72 72 72 72 72 81 0 0 82 72 72 72 72 14 38
16 16 0 0 0 0 0 0 0 0 0 0 0 0 83 72 72 72 72 72 72 72 72 72 72 72 72 72 76 76 72 81 82 72 76 76 72 72 76 76
16 16 0 0 0 0 0 0 0 0 0 0 0 0 0 83 72 72 72 72 72 72 72 72 72 72 72 72 72 76 72 72 72 72 76 72 72 72 76 76
36 12 0 0 0 0 0 0 0 0 0 0 0 0 0 82 72 72 72 72 72 72 72 72 72 72 72 72 72 72 72 72 72 72 72 72 72 72 14 38
16 16 0 0 0 0 0 0 0 0 0 0 0 0 0 83 72 72 72 72 72 72 72 72 72 72 72 72 72 72 72 72 72 72 72 72 72 72 76 76
16 16 0 0 0 0 0 0 0 0 0 0 0 0 0 0 83 72 72 72 72 72 72 72 72 72 72 72 72 72 72 72 72 72 72 72 72 72 76 76
36 12 0 0 0 0 0 0 0 0 0 0 0 0 0 0 0 83 72 72 72 72 72 72 72 72 72 72 72 72 72 72 72 72 72 72 72 72 14 38
16 16 0 0 0 0 0 0 0 0 0 0 0 0 0 0 0 0 82 72 72 72 72 72 72 72 72 72 72 72 72 72 72 72 72 72 72 72 76 76