39 16 39 16 39 16 39 16 15 72 40 81 0 0 64 84 84 84 84 84 66 0 0 83 72 72 72 72 72 72 72 15 16 39 16 39 16 39 16 39
15 15 15 15 15 15 15 15 15 72 40 80 0 0 64 84 84 84 84 84 66 0 0 82 72 72 72 72 72 72 72 15 15 15 15 15 15 15 15 15
72 72 72 72 72 72 72 72 72 72 40 81 0 0 64 84 84 84 84 84 66 0 0 83 72 72 72 72 72 72 72 72 72 72 72 72 72 72 72 72
72 72 72 72 72 72 72 72 72 72 40 80 0 0 64 84 84 84 84 84 66 0 0 82 72 72 72 72 72 72 72 72 72 72 72 72 72 72 72 72
72 72 72 72 72 72 72 72 72 72 40 81 0 0 64 84 84 84 84 84 70 0 0 83 72 72 72 72 72 72 72 72 72 72 72 72 72 72 72 72
72 72 72 72 76 72 72 72 72 72 40 80 0 0 64 84 84 84 84 66 0 0 0 82 72 72 72 72 72 72 72 72 72 72 72 72 72 72 72 72
72 72 72 72 72 72 72 72 72 72 40 0 0 0 64 84 84 84 84 66 0 0 82 72 72 72 72 72 72 72 72 72 72 72 72 72 72 72 72 72
72 72 72 72 72 72 72 72 72 80 40 0 0 68 84 84 84 84 84 66 0 0 83 72 72 72 72 72 72 72 72 72 72 72 72 72 72 72 72 72
72 72 72 72 72 72 72 72 72 81 40 0 0 64 84 84 84 84 84 70 0 0 82 72 72 72 72 72 72 72 72 72 72 72 72 72 72 72 72 72
72 72 72 72 72 72 72 72 72 72 40 0 0 64 84 84 84 84 66 0 0 0 83 72 72 72 72 72 72 72 72 76 72 72 72 72 72 72 72 72
72 72 72 72 72 72 72 72 72 72 40 0 0 64 84 84 84 84 66 0 0 0 82 72 72 72 72 72 72 72 72 72 72 72 72 72 72 72 72 72
72 72 72 72 72 72 72 72 72 72 40 0 0 64 84 84 84 84 66 0 0 82 72 72 72 72 72 72 72 72 72 72 72 72 72 72 72 72 72 72
72 72 72 72 72 72 72 72 72 72 40 0 0 64 84 84 84 84 66 0 0 83 72 72 72 72 72 72 72 72 72 72 72 72 72 72 72 72 72 72
72 72 72 72 72 72 72 72 72 72 40 0 0 64 84 84 84 84 66 0 0 82 72 72 72 72 72 72 72 72 72 72 72 72 72 72 72 72 72 72
72 72 72 72 72 72 72 72 72 72 40 0 0 64 84 84 84 84 66 0 0 83 72 72 72 72 72 72 72 72 72 72 72 72 72 76 72 72 72 72
72 72 72 72 72 72 72 72 72 72 40 0 0 64 84 84 84 84 66 0 0 82 72 72 72 72 72 72 72 72 72 72 72 72 72 72 72 72 72 72
72 72 72 72 72 76 72 72 72 72 40 0 0 64 84 84 84 84 66 0 0 83 72 72 72 72 72 72 72 72 72 72 72 72 72 72 72 72 72 72
72 72 72 72 72 72 72 72 72 72 40 0 0 64 84 84 84 84 66 0 0 82 72 72 72 72 72 72 72 72 72 72 72 72 72 72 72 72 72 72
72 72 72 72 72 72 72 72 72 72 40 0 0 64 84 84 84 84 66 0 82 72 72 72 72 72 72 72 72 72 72 72 72 72 72 72 72 72 72 72
72 72 80 83 72 72 72 72 72 72 40 0 16 64 84 84 84 84 66 16 83 72 72 72 72 72 72 72 72 72 72 72 72 74 80 83 74 72 72 72
72 80 0 0 83 72 72 72 72 72 40 41 41 41 41 41 41 41 41 41 41 41 41 41 40 72 72 72 72 72 72 72 72 80 62 2 83 72 72 72
72 81 0 60 82 72 72 72 72 72 40 41 41 41 41 41 41 41 41 41 41 41 41 41 40 72 72 72 72 72 72 72 72 81 2 2 82 72 72 72
72 72 81 82 72 72 72 72 72 72 80 0 16 64 84 84 84 84 66 16 0 83 72 72 40 72 72 72 72 72 72 72 72 74 81 82 74 72 72 72
72 72 72 76 72 72 72 72 72 72 81 0 0 64 84 84 84 84 66 0 0 82 72 72 40 72 72 72 72 72 72 72 72 72 72 72 72 72 72 72
72 72 72 72 72 72 72 72 72 72 80 0 0 64 84 84 84 84 66 0 0 83 72 72 40 72 72 72 72 72 72 72 72 72 72 72 72 72 72 72
72 72 72 72 72 72 72 72 72 72 81 0 0 64 84 84 84 84 66 0 0 82 72 72 40 72 72 72 72 72 72 72 72 72 72 72 72 72 72 72
72 72 72 72 72 72 72 72 72 72 80 0 0 64 84 84 84 84 66 0 0 83 72 72 40 72 72 72 72 72 72 76 72 72 72 72 72 72 72 72
72 72 72 72 72 72 72 72 72 72 81 0 0 64 84 84 84 84 66 0 0 82 72 72 40 72 72 72 72 72 72 72 72 72 72 72 72 72 72 72
72 72 72 72 72 72 72 72 72 72 72 81 0 64 84 84 84 84 66 0 0 83 72 72 40 40 72 72 72 72 72 72 72 72 72 72 72 72 72 72
72 72 72 72 72 72 72 72 72 72 72 80 0 64 84 84 84 84 66 0 0 82 72 72 76 40 72 72 72 72 72 72 72 72 72 72 72 72 72 72
72 72 72 72 72 72 72 72 72 72 80 0 0 64 84 84 84 84 66 0 0 83 72 72 72 40 72 72 72 72 72 72 72 72 72 72 72 72 72 72
72 72 72 72 72 72 72 72 72 72 81 0 0 64 84 84 84 84 66 0 0 0 83 72 72 40 72 72 72 72 72 72 72 72 72 72 72 72 72 72
72 72 72 72 72 72 76 72 72 72 80 0 0 64 84 84 84 84 66 0 0 0 0 83 72 40 72 72 72 72 72 72 72 72 72 72 72 72 72 72
72 72 72 72 72 72 72 72 72 72 81 0 0 64 84 84 84 84 84 71 0 0 0 82 72 40 72 72 72 72 72 72 72 72 72 72 72 72 72 72
72 72 72 72 72 72 72 72 72 72 80 0 0 64 84 84 84 84 84 66 0 0 82 72 72 40 72 72 72 72 72 72 72 72 72 72 72 72 72 72
72 72 72 72 72 72 72 72 72 72 81 0 0 69 84 84 84 84 84 66 0 0 83 72 72 40 72 72 72 72 72 72 72 72 72 72 72 72 72 72
72 72 72 72 72 72 72 72 72 72 80 0 0 0 64 84 84 84 84 66 0 0 82 72 72 40 72 72 72 72 72 72 72 72 72 72 72 72 72 72
72 72 72 72 72 72 72 72 72 72 81 0 0 0 64 84 84 84 84 66 0 0 83 72 72 40 72 72 72 72 72 72 72 72 72 72 72 72 72 72
13 13 13 13 13 13 13 13 13 72 72 81 0 0 64 84 84 84 84 66 0 0 82 72 72 40 72 72 72 72 72 13 13 13 13 13 13 13 13 13
37 16 37 16 37 16 37 16 13 72 72 80 0 0 64 84 84 84 84 66 0 0 83 72 72 40 72 72 72 72 72 13 16 37 16 37 16 37 16 37