84 84 86 86 84 85 85 84 87 87 86 84 86 84 87 86 85 87 85 86 87 84 84 85 85 85 87 84 87 87 87 85 84 85 87 84 84 86 86 87 84 84 84 84 84 84 84 84 84 84 84 84 84 84 84 84 84 84 84 84
84 84 85 84 84 85 85 85 87 84 87 87 87 85 84 85 87 84 84 86 86 84 87 84 86 84 84 87 84 85 85 85 85 85 84 87 86 84 86 84 87 86 85 84 84 84 84 84 84 84 84 84 84 84 84 84 84 84 84 84
87 86 84 86 87 84 86 84 84 87 84 85 85 85 85 85 84 84 87 87 87 87 85 84 87 86 84 84 84 84 84 85 84 85 85 84 87 87 87 85 84 85 87 84 84 84 84 84 84 84 84 84 84 84 84 84 84 84 84 84
84 84 86 85 85 84 87 86 84 84 84 84 84 85 84 85 85 85 85 85 85 87 84 86 85 85 87 86 86 85 85 86 87 87 85 87 84 85 85 85 85 85 84 84 84 84 84 84 84 84 84 84 84 84 84 84 84 84 84 84
85 86 85 85 84 86 85 85 87 86 86 85 85 86 87 87 85 87 84 85 86 84 87 87 84 87 87 85 87 87 84 87 85 85 87 84 84 84 84 85 84 85 85 84 84 84 84 84 84 84 84 84 84 84 84 84 84 84 84 84
86 84 87 87 87 87 84 87 87 85 87 87 84 87 85 85 87 84 86 84 87 84 85 86 86 86 85 86 84 87 85 86 86 86 86 86 86 85 85 86 87 87 85 84 84 84 84 84 84 84 84 84 84 84 84 84 84 84 84 84
85 87 84 85 85 86 86 86 85 86 84 87 85 86 86 86 86 87 86 87 85 86 84 86 87 86 84 86 84 85 86 86 87 86 84 85 87 87 84 87 85 85 87 84 84 84 84 84 84 84 84 84 84 84 84 84 84 84 84 84
84 86 85 85 84 86 87 86 84 86 84 85 86 86 87 86 84 86 85 85 85 85 84 86 87 87 86 87 87 85 87 87 87 85 85 87 86 84 87 85 84 84 84 84 84 84 84 84 84 84 84 84 84 84 84 84 84 84 84 84
85 87 86 86 84 86 87 87 86 87 87 85 87 87 87 85 85 87 86 84 84 86 87 87 86 86 84 86 86 85 87 85 85 84 84 87 84 87 87 84 84 84 84 84 84 84 84 84 84 84 84 84 84 84 84 84 84 84 84 84
85 86 87 86 87 87 86 86 84 86 86 85 87 85 85 84 84 87 84 87 85 86 86 87 87 87 85 85 84 84 86 85 85 85 84 86 87 86 84 84 84 84 84 84 84 84 84 84 84 84 84 84 84 84 84 84 84 84 84 84
84 86 84 87 86 87 87 87 87 87 85 85 84 84 86 85 85 85 84 86 84 86 84 84 85 87 86 85 87 87 85 84 65 65 65 65 65 86 84 84 84 84 84 84 84 84 84 84 84 84 84 84 84 84 84 84 84 84 84 84
85 84 84 85 85 84 85 85 86 86 84 85 85 85 87 84 87 87 87 85 84 85 87 84 86 84 56 56 56 86 86 70 3 3 3 3 3 69 84 84 56 56 56 86 84 84 84 84 84 84 84 84 84 84 84 84 84 84 84 84
84 86 85 85 85 84 86 84 85 85 87 84 86 84 84 87 84 85 85 85 85 85 84 84 87 87 56 36 12 87 66 16 3 3 3 3 3 16 64 86 14 38 56 86 84 84 84 84 84 84 84 84 84 84 84 84 84 84 84 84
87 86 84 85 85 84 86 86 86 85 85 84 87 86 84 84 84 84 84 85 84 85 85 85 85 87 56 36 12 12 12 12 3 3 3 3 3 14 14 14 14 38 56 86 84 84 84 84 84 84 84 84 84 84 84 84 84 84 84 84
84 87 86 87 87 84 85 87 86 86 84 86 85 85 87 86 86 85 85 86 87 87 85 87 86 84 56 36 12 84 66 16 3 3 63 3 3 16 64 85 14 38 56 86 84 84 84 84 84 84 84 84 84 84 84 84 84 84 84 84
85 86 85 86 86 84 86 86 87 85 87 87 84 87 87 85 87 87 84 87 85 85 87 84 87 84 56 56 56 86 66 3 3 3 3 3 3 3 64 84 56 56 56 84 84 84 84 84 84 84 84 84 84 84 84 84 84 84 84 84
87 87 85 86 86 84 84 84 84 84 85 86 86 86 85 86 84 87 85 86 86 86 86 87 85 86 84 87 86 87 66 3 3 3 3 3 3 3 64 86 85 84 85 87 84 84 84 84 84 84 84 84 84 84 84 84 84 84 84 84
85 84 84 86 86 84 84 84 84 84 84 86 87 86 84 86 84 85 86 86 87 86 84 86 85 85 86 86 87 86 85 71 3 3 40 3 3 68 87 84 84 85 87 85 84 84 84 84 84 84 84 84 84 84 84 84 84 84 84 84
87 86 86 85 85 84 84 84 84 84 84 86 87 87 86 87 87 85 87 87 87 85 85 87 84 86 84 84 85 85 86 66 3 3 40 3 3 64 84 87 86 84 84 84 84 84 84 84 84 84 84 84 84 84 84 84 84 84 84 84
87 85 86 86 86 87 86 84 85 86 87 84 87 84 87 86 86 85 87 85 85 84 84 87 85 86 84 85 87 86 84 85 71 3 40 3 68 87 84 84 87 86 84 86 84 84 84 84 84 84 84 84 84 84 84 84 84 84 84 84
85 84 85 86 86 85 87 84 86 87 86 86 84 85 87 87 85 85 84 84 86 85 85 85 84 86 84 85 86 84 84 85 66 3 40 3 64 87 87 84 84 84 84 86 84 84 84 84 84 84 84 84 84 84 84 84 84 84 84 84
85 86 86 84 84 84 86 84 84 85 85 86 84 56 56 56 56 56 86 84 85 85 85 86 86 85 86 85 85 85 85 85 84 71 40 68 86 85 84 85 85 84 85 85 87 84 84 84 84 84 84 84 84 84 84 84 84 84 84 84
84 87 85 87 87 87 85 86 87 85 85 84 84 56 39 39 39 56 85 86 85 87 85 85 84 87 84 84 87 84 87 86 87 66 40 64 85 85 84 86 85 87 87 85 84 84 84 84 84 84 84 84 84 84 84 84 84 84 84 84
87 87 85 87 87 85 85 85 86 85 85 86 87 56 15 15 15 56 86 85 87 84 85 86 85 84 86 87 84 85 87 84 85 66 40 64 84 86 84 85 86 85 87 87 87 84 84 84 84 84 84 84 84 84 84 84 84 84 84 84
85 86 87 86 86 84 86 84 85 87 87 84 86 85 87 15 86 85 87 85 84 85 85 86 84 84 85 87 84 85 84 85 84 70 40 69 87 87 85 87 84 87 85 85 84 84 84 84 84 84 84 84 84 84 84 84 84 84 84 84
87 84 87 87 87 87 87 84 84 86 86 85 85 85 65 15 65 65 65 84 85 85 84 85 86 87 84 84 87 86 87 87 70 6 40 4 69 87 84 86 86 86 85 86 87 84 84 84 84 84 84 84 84 84 84 84 84 84 84 84
87 84 84 85 85 86 86 86 87 86 86 87 87 70 16 15 16 0 0 69 65 84 84 86 86 87 84 85 84 65 65 70 7 5 40 7 7 69 65 65 85 87 86 85 84 86 84 84 84 84 84 84 84 84 84 84 84 84 84 84
85 87 84 86 84 85 85 84 86 86 86 86 66 0 0 0 0 0 0 0 0 69 65 87 86 85 84 65 70 4 7 7 4 6 40 5 6 5 6 4 64 85 84 86 84 84 84 84 84 84 84 84 84 84 84 84 84 84 84 84
87 85 86 86 86 87 86 84 85 85 85 85 66 0 0 0 0 0 0 0 0 0 0 69 65 65 70 5 6 7 4 4 4 5 7 7 6 4 5 5 64 85 86 85 84 84 84 84 84 84 84 84 84 84 84 84 84 84 84 84
85 84 85 86 86 85 87 84 86 86 86 85 66 0 0 0 60 0 0 41 41 41 41 41 41 41 41 41 41 41 5 5 5 7 4 5 7 42 5 7 64 85 86 84 86 84 84 84 84 84 84 84 84 84 84 84 84 84 84 84
85 86 86 84 84 84 86 84 84 86 86 87 66 0 0 0 0 0 0 0 0 0 0 68 67 67 71 4 5 7 6 4 5 6 6 5 5 42 5 68 86 86 85 87 86 84 84 84 84 84 84 84 84 84 84 84 84 84 84 84
84 87 85 87 87 87 85 86 87 87 87 85 66 0 0 0 0 0 0 0 0 68 67 85 84 86 85 67 71 7 5 5 7 7 68 71 5 42 7 64 84 84 84 86 86 84 84 84 84 84 84 84 84 84 84 84 84 84 84 84
87 87 85 87 87 85 85 85 86 86 86 85 85 71 16 13 16 0 0 68 67 86 86 86 87 85 86 87 84 67 67 67 67 67 85 85 71 42 68 86 87 86 87 86 85 87 84 84 84 84 84 84 84 84 84 84 84 84 84 84
85 86 87 86 86 84 86 84 85 84 84 85 85 87 67 13 67 67 67 86 87 85 85 86 84 84 85 85 85 85 87 84 87 86 84 86 66 42 64 87 86 85 87 86 85 84 84 84 84 84 84 84 84 84 84 84 84 84 84 84
87 84 87 87 87 87 87 84 84 85 85 84 84 87 84 13 85 87 84 87 86 87 85 86 85 86 86 84 86 85 85 87 84 86 87 87 66 42 64 87 84 85 86 85 86 86 84 84 84 84 84 84 84 84 84 84 84 84 84 84
87 84 84 85 85 86 86 86 87 85 85 87 85 56 13 13 13 56 87 84 86 84 87 86 84 85 85 85 84 87 86 87 87 86 87 84 70 42 69 86 87 87 87 87 87 84 84 84 87 84 84 84 84 84 84 84 84 84 84 84
85 87 84 86 84 85 85 84 86 84 84 87 86 56 37 37 37 56 84 87 85 86 86 86 85 84 84 85 85 86 86 86 86 85 85 66 1 42 1 64 87 86 86 84 87 86 87 84 86 84 84 84 84 84 84 84 84 84 84 84
87 87 84 86 86 86 85 84 85 84 84 84 85 56 56 56 56 56 85 87 85 85 85 87 85 87 86 86 87 86 84 85 86 86 85 70 1 42 1 69 87 86 84 85 87 86 86 84 87 84 84 84 84 84 84 84 84 84 84 84
87 86 84 85 87 86 86 84 86 86 86 87 86 84 85 84 87 84 87 86 87 85 86 86 84 86 87 87 87 86 86 84 85 86 66 1 1 42 1 1 64 84 87 87 86 86 87 84 86 84 84 84 84 84 84 84 84 84 84 84
84 87 84 86 86 87 85 84 86 86 86 85 87 84 86 87 87 85 85 85 87 86 87 86 85 87 84 87 85 85 87 86 86 85 70 1 1 42 1 1 69 87 84 85 84 84 86 84 85 84 84 84 84 84 84 84 84 84 84 84
84 84 84 84 84 84 84 84 84 84 84 84 86 84 84 87 85 84 86 87 86 84 85 87 85 84 87 84 87 87 86 87 84 66 1 1 1 1 1 1 1 64 85 84 85 86 85 84 85 84 84 84 84 84 84 84 84 84 84 84
84 84 84 84 84 84 84 84 84 87 87 87 85 86 87 85 84 84 87 86 86 87 86 85 85 86 85 86 86 56 56 56 86 66 1 1 1 1 1 1 1 64 84 56 56 56 85 84 84 84 84 84 84 84 84 84 84 84 84 84
84 84 84 84 84 84 84 84 84 87 87 85 85 85 86 86 84 86 86 84 86 85 84 84 84 86 86 87 84 56 36 12 87 66 16 1 1 61 1 1 16 64 86 14 38 56 84 84 84 84 84 84 84 84 84 84 84 84 84 84
84 84 84 84 84 84 84 84 84 86 86 84 86 84 85 85 86 87 85 85 87 87 85 87 85 87 87 86 87 56 36 12 12 12 12 1 1 1 1 1 14 14 14 14 38 56 84 84 87 84 84 84 84 84 84 84 84 84 84 84
84 84 84 84 84 84 84 84 84 87 87 87 87 84 84 85 87 85 86 87 84 85 87 84 87 85 85 84 86 56 36 12 84 66 16 1 1 1 1 1 16 64 85 14 38 56 87 84 86 84 84 84 84 84 84 84 84 84 84 84
84 84 84 84 84 84 84 84 84 85 85 86 86 86 87 86 84 85 84 86 84 87 87 86 84 87 84 85 85 56 56 56 86 86 71 1 1 1 1 1 68 84 84 56 56 56 86 84 87 84 84 84 84 84 84 84 84 84 84 84
84 84 84 84 84 84 84 84 84 86 84 85 85 84 86 85 85 87 87 87 87 84 87 85 87 86 87 84 87 87 84 85 87 85 84 67 67 67 67 67 86 86 87 84 87 86 84 85 84 84 84 84 84 84 84 84 84 84 84 84
84 84 84 84 84 84 84 84 84 84 84 84 84 84 84 84 84 84 84 84 84 84 84 84 84 84 84 84 84 84 84 84 84 84 84 84 84 84 84 84 84 84 84 84 84 84 84 84 84 84 84 84 84 84 84 84 84 84 84 84
84 84 84 84 84 84 84 84 84 84 84 84 84 84 84 84 84 84 84 84 84 84 84 84 84 84 84 84 84 84 84 84 84 84 84 84 84 84 84 84 84 84 84 84 84 84 84 84 84 84 84 84 84 84 84 84 84 84 84 84
84 84 84 84 84 84 84 84 84 84 84 84 84 84 84 84 84 84 84 84 84 84 84 84 84 84 84 84 84 84 84 84 84 84 84 84 84 84 84 84 84 84 84 84 84 84 84 84 84 84 84 84 84 84 84 84 84 84 84 84
84 84 84 84 84 84 84 84 84 84 84 84 84 84 84 84 84 84 84 84 84 84 84 84 84 84 84 84 84 84 84 84 84 84 84 84 84 84 84 84 84 84 84 84 84 84 84 84 84 84 84 84 84 84 84 84 84 84 84 84
84 84 84 84 84 84 84 84 84 84 84 84 84 84 84 84 84 84 84 84 84 84 84 84 84 84 84 84 84 84 84 84 84 84 84 84 84 84 84 84 84 84 84 84 84 84 84 84 84 84 84 84 84 84 84 84 84 84 84 84
84 84 84 84 84 84 84 84 84 84 84 84 84 84 84 84 84 84 84 84 84 84 84 84 84 84 84 84 84 84 84 84 84 84 84 84 84 84 84 84 84 84 84 84 84 84 84 84 84 84 84 84 84 84 84 84 84 84 84 84
84 84 84 84 84 84 84 84 84 84 84 84 84 84 84 84 84 84 84 84 84 84 84 84 84 84 84 84 84 84 84 84 84 84 84 84 84 84 84 84 84 84 84 84 84 84 84 84 84 84 84 84 84 84 84 84 84 84 84 84
84 84 84 84 84 84 84 84 84 84 84 84 84 84 84 84 84 84 84 84 84 84 84 84 84 84 84 84 84 84 84 84 84 84 84 84 84 84 84 84 84 84 84 84 84 84 84 84 84 84 84 84 84 84 84 84 84 84 84 84
84 84 84 84 84 84 84 84 84 84 84 84 84 84 84 84 84 84 84 84 84 84 84 84 84 84 84 84 84 84 84 84 84 84 84 84 84 84 84 84 84 84 84 84 84 84 84 84 84 84 84 84 84 84 84 84 84 84 84 84
84 84 84 84 84 84 84 84 84 84 84 84 84 84 84 84 84 84 84 84 84 84 84 84 84 84 84 84 84 84 84 84 84 84 84 84 84 84 84 84 84 84 84 84 84 84 84 84 84 84 84 84 84 84 84 84 84 84 84 84
84 84 84 84 84 84 84 84 84 84 84 84 84 84 84 84 84 84 84 84 84 84 84 84 84 84 84 84 84 84 84 84 84 84 84 84 84 84 84 84 84 84 84 84 84 84 84 84 84 84 84 84 84 84 84 84 84 84 84 84