60 72 72 72 72 16 0 0 0 0 0 0 0 0 0 0 0 0 0 0 0 16 0 64 84 66 0 16 0 0 0 0 0 0 0 0 16 16 16 16 16 16 16 16 16 16 16 16 16 16
72 72 72 72 72 16 0 0 0 0 0 0 0 0 0 0 0 0 0 0 0 41 41 41 41 41 41 41 0 2 0 0 0 0 0 0 0 0 16 39 16 39 16 39 16 39 16 0 0 36
72 72 72 72 72 16 0 0 0 0 2 0 0 0 0 0 0 0 0 0 0 41 41 41 41 41 41 41 0 0 2 2 0 0 0 0 0 0 0 0 0 2 0 0 0 2 0 0 0 16
72 72 72 72 80 0 0 0 0 0 2 0 0 0 0 0 0 0 0 0 0 16 69 84 66 0 0 16 0 0 0 2 2 0 0 0 16 0 0 2 2 2 0 0 0 2 0 2 0 36
72 72 72 80 0 0 0 0 0 0 0 2 0 0 0 0 0 0 0 0 0 16 0 64 84 71 0 16 0 0 0 2 2 2 2 0 16 0 0 0 0 0 0 0 0 2 2 2 0 16
16 16 16 0 0 0 0 0 0 0 0 2 0 0 0 0 0 0 0 0 0 41 41 41 41 41 41 41 0 0 0 0 2 2 0 0 0 0 0 0 0 0 0 0 0 0 0 0 0 36
0 0 0 0 0 0 2 0 0 0 0 2 0 0 0 0 0 0 0 0 0 41 41 41 41 41 41 41 0 0 0 0 2 2 2 2 0 0 0 0 0 0 0 0 0 0 0 0 0 16
0 0 0 2 2 0 0 0 0 0 0 0 0 0 0 0 0 0 0 0 0 41 41 41 41 41 41 41 0 0 0 0 2 2 0 0 0 0 0 0 0 0 0 0 0 0 0 0 0 36
0 0 0 0 2 0 0 0 0 0 2 0 2 0 0 2 0 0 0 0 0 16 16 0 64 84 66 16 0 0 0 0 0 2 0 2 16 0 0 0 0 0 0 0 0 0 0 2 0 16
0 0 0 0 0 0 0 0 0 0 2 2 2 0 0 0 0 0 0 0 0 0 0 16 69 84 84 71 16 16 0 0 0 0 2 0 16 0 0 0 0 0 0 0 0 0 0 0 0 36
0 0 0 0 2 2 2 2 2 0 0 0 0 0 0 0 0 0 0 0 0 0 0 41 41 41 41 41 41 41 0 0 0 2 0 0 0 0 0 0 0 0 0 0 0 0 0 0 0 16
0 0 0 0 0 0 0 0 0 0 0 2 2 2 0 0 0 0 0 0 2 2 0 41 41 41 41 41 41 41 0 0 0 0 0 0 0 0 16 37 16 37 16 37 16 37 16 2 0 36
0 0 0 0 0 0 0 0 0 0 0 2 2 2 0 0 0 0 0 0 2 2 2 16 0 0 69 84 84 16 0 0 0 0 0 0 16 16 16 16 16 16 16 16 16 16 16 16 16 16
0 0 0 0 0 0 0 0 0 0 2 2 0 0 2 0 0 0 0 2 2 0 0 0 0 0 0 69 84 84 71 0 0 0 0 2 0 0 0 2 2 2 0 2 0 0 0 0 0 0
0 0 0 0 0 0 0 0 0 2 0 0 2 0 0 2 2 0 2 2 0 0 0 0 0 0 0 0 69 84 84 71 0 0 0 0 0 0 0 2 0 0 2 2 2 0 0 0 0 0
0 0 0 0 0 0 0 0 0 0 2 2 0 0 2 2 2 0 2 0 2 0 0 0 0 0 0 0 0 64 84 66 0 0 0 0 2 2 2 0 0 0 0 2 2 0 0 0 0 0
0 0 0 0 0 0 0 0 0 0 0 0 2 0 0 0 2 0 0 2 0 0 0 0 0 0 0 0 0 69 84 84 67 67 67 67 71 2 2 0 0 0 0 0 0 0 0 0 0 0
67 71 0 0 0 0 0 0 0 0 0 2 2 0 0 0 2 2 0 2 0 0 0 0 0 0 0 0 0 0 64 84 86 86 86 86 86 67 71 0 0 0 0 0 0 0 0 0 0 0
84 84 71 0 16 40 40 16 0 0 0 0 0 0 0 0 0 0 0 0 0 0 0 0 0 0 0 0 0 0 64 84 86 65 65 65 86 86 86 71 0 0 0 0 0 0 0 0 0 0
69 84 84 67 67 40 40 67 71 0 0 0 0 0 0 0 0 0 0 0 0 0 0 0 0 0 0 0 0 68 84 84 70 0 2 2 69 65 86 86 67 71 56 40 40 56 0 0 0 0
0 69 84 84 84 40 40 84 84 67 71 0 0 0 0 0 0 0 0 0 0 0 0 0 0 0 0 0 0 64 84 66 0 2 2 2 2 2 69 86 86 86 67 40 40 67 67 71 0 0
0 0 69 65 65 40 40 65 84 84 84 71 0 0 0 0 0 0 0 0 0 0 0 0 0 0 0 0 0 64 84 70 0 0 0 0 2 2 2 69 65 86 86 40 40 86 86 86 71 0
0 0 0 0 16 40 40 16 69 65 84 84 67 71 0 0 0 0 0 0 0 0 0 0 0 0 0 0 68 84 66 0 0 0 2 0 2 2 2 2 2 69 65 40 40 65 65 86 86 71
0 0 0 0 0 0 0 0 0 0 69 84 84 84 67 71 0 0 0 0 0 0 0 0 0 0 68 67 84 84 70 0 0 0 2 2 2 2 2 2 2 2 56 40 40 56 2 69 86 86
0 0 0 0 0 0 0 0 0 0 0 69 65 84 84 84 67 67 67 67 67 67 67 67 67 67 84 84 84 70 0 0 0 2 2 2 2 2 2 2 2 2 2 2 2 2 2 2 69 65
0 0 0 0 0 0 0 0 0 0 0 0 0 69 65 84 84 84 84 84 84 84 84 84 84 84 84 65 70 0 0 2 0 0 0 0 0 0 0 0 0 0 0 0 0 0 0 0 0 0
0 0 0 0 2 2 0 0 0 0 0 0 0 0 0 69 65 65 65 65 84 84 84 65 65 65 70 0 0 0 0 0 0 0 0 0 0 0 0 0 0 0 0 0 0 0 0 0 0 0
16 16 16 16 16 16 16 16 16 16 16 16 16 16 0 0 0 0 56 0 64 84 66 0 56 0 0 0 0 0 0 0 0 0 0 0 0 0 0 0 0 0 0 0 0 0 0 0 0 0
36 0 0 16 39 16 39 16 39 16 39 16 0 0 0 0 0 0 41 41 41 41 41 41 41 0 0 0 0 0 2 0 0 0 0 0 0 0 0 0 0 0 0 0 0 0 0 0 0 0
16 0 0 0 2 0 0 0 2 0 0 0 0 0 0 0 0 0 41 41 41 41 41 41 41 0 0 0 0 0 0 0 0 0 0 0 0 0 0 0 0 0 0 0 0 0 0 0 0 0
36 0 2 0 2 0 0 0 2 2 2 0 0 16 0 2 0 0 56 0 64 84 66 0 56 0 0 0 0 0 0 0 0 0 0 0 0 0 0 0 0 0 0 0 0 0 0 0 0 0
16 0 2 2 2 0 0 0 0 0 0 0 0 16 0 0 2 0 56 0 64 84 66 0 56 0 0 0 0 0 0 0 0 0 0 0 0 2 2 0 0 0 0 0 0 0 0 0 0 2
36 0 0 0 0 0 0 0 0 0 0 0 0 0 0 0 0 0 41 41 41 41 41 41 41 0 0 0 0 0 2 0 0 0 0 0 0 0 0 2 2 0 0 0 0 0 0 0 0 0
16 0 0 0 0 0 0 0 0 0 0 0 0 0 0 0 0 0 41 41 41 41 41 41 41 0 0 0 0 0 0 0 0 0 0 2 2 0 0 2 0 0 0 0 0 0 2 0 0 0
36 0 0 0 0 0 0 0 0 0 0 0 0 0 0 0 0 2 41 41 41 41 41 41 41 0 0 0 0 0 0 2 0 2 2 0 2 0 2 0 0 0 0 0 2 2 2 56 56 56
16 0 2 0 0 0 0 0 0 0 0 0 0 16 0 0 0 0 56 0 64 84 66 0 56 0 0 2 0 0 0 0 0 0 0 2 2 2 0 0 0 0 0 0 2 2 82 72 72 72
36 0 0 0 0 0 0 0 0 0 0 0 0 16 0 0 0 0 0 56 69 86 84 71 0 56 0 0 0 0 0 0 0 0 0 0 0 2 0 0 0 0 0 0 2 82 72 72 72 72
16 0 0 0 0 0 0 0 0 0 0 0 0 0 0 2 0 0 0 41 41 41 41 41 41 41 0 0 0 0 0 0 0 0 0 0 0 0 2 2 2 0 0 0 56 72 72 72 72 72
36 0 2 16 37 16 37 16 37 16 37 16 0 0 2 0 0 0 0 41 41 41 41 41 41 41 0 0 0 0 0 0 0 0 0 0 0 0 0 0 0 0 0 0 56 72 72 72 72 72
16 16 16 16 16 16 16 16 16 16 16 16 16 16 0 0 0 0 0 56 0 64 84 66 0 56 0 0 0 0 0 0 0 0 0 0 0 0 0 0 0 0 0 0 56 72 72 72 72 62