0 0 0 76 0 0 0 76 76 76 76 76 76 76 76 76 76 76 76 76 76 76 76 76 76 76 0 0 0 0 0 0 0 0 0
0 0 0 0 0 0 0 0 0 0 0 0 0 0 0 84 84 84 0 0 0 0 0 0 0 0 0 0 0 0 76 0 0 0 0
0 76 0 76 0 0 76 76 76 76 76 76 76 76 76 36 76 38 76 76 76 76 76 76 76 76 76 0 76 0 0 0 76 0 0
0 0 0 0 0 0 0 76 76 76 76 76 76 76 76 76 76 76 76 76 76 76 76 76 76 0 0 0 0 0 0 0 0 0 76
0 76 0 0 0 0 0 0 0 76 76 76 76 76 76 76 76 76 76 76 76 76 76 0 0 0 0 0 76 0 76 0 76 0 0
0 0 0 0 0 0 0 0 0 76 0 76 76 76 76 76 76 76 76 76 76 0 0 0 0 0 0 76 0 0 0 0 0 0 76
0 0 84 84 84 0 0 0 0 0 0 84 84 76 84 84 84 76 84 84 84 0 76 0 0 0 0 0 0 44 44 44 0 0 0
84 84 84 84 84 84 0 0 0 0 0 76 84 84 84 76 84 84 84 76 84 76 0 0 76 0 0 0 44 44 44 44 44 44 44
84 84 84 84 84 84 84 0 0 0 0 84 84 76 84 84 84 76 84 84 84 0 0 0 0 0 0 44 44 44 44 44 44 44 44
84 0 0 60 84 84 84 41 41 41 41 41 41 41 41 84 84 84 41 41 41 41 41 41 41 41 41 44 44 44 60 0 0 0 44
84 0 84 84 84 84 84 41 41 41 41 41 41 41 41 84 84 84 41 41 41 41 41 41 41 41 41 44 44 44 44 44 44 0 44
84 0 84 84 84 84 0 0 76 0 0 84 84 76 84 84 84 76 84 84 84 76 0 0 76 0 0 0 44 44 44 44 44 0 44
0 0 84 84 84 0 76 0 0 0 0 76 84 84 84 76 84 84 84 76 84 0 76 0 0 0 0 76 0 44 44 44 0 0 0
0 0 0 0 0 0 0 0 0 0 0 84 84 76 84 84 84 76 84 84 84 0 0 0 0 0 0 0 0 0 0 0 0 0 0
0 0 0 76 0 0 0 76 76 76 76 76 76 76 76 76 76 76 76 76 76 76 76 76 76 76 76 76 0 0 0 76 0 76 0
0 0 0 0 0 76 0 0 76 76 76 76 76 76 76 76 76 76 76 76 76 76 76 76 76 76 76 76 76 76 0 0 0 0 0
0 0 0 0 0 0 0 0 76 76 76 76 76 76 76 76 76 76 76 76 76 76 76 76 76 76 76 76 76 0 0 76 0 0 0
76 0 0 0 0 0 0 0 0 0 0 0 0 0 0 84 84 84 0 0 0 0 0 0 0 0 0 0 0 0 0 0 0 0 0
0 0 0 0 76 0 76 0 76 76 76 76 76 76 76 36 76 38 76 76 76 76 76 76 76 76 76 76 0 0 76 0 76 0 0
0 0 0 0 0 0 0 0 76 76 76 76 76 76 76 76 76 76 76 76 76 76 76 76 76 76 76 76 0 0 0 0 0 0 0