56 56 39 56 39 56 39 56 39 56 41 41 41 41 41 41 41 41 41 41 41 41 41 41 41 41 41 41 41 41 41 41 41 41 41 41 41 41 41 41 41 41 41 41 41 41 41 41 41 60
56 82 15 32 31 31 31 31 35 56 0 0 0 0 0 0 0 0 0 0 0 82 42 0 68 71 0 42 81 0 0 0 0 0 0 0 0 0 0 0 16 32 31 31 31 31 35 14 81 42
36 12 80 28 24 24 24 24 30 56 0 0 0 0 0 0 0 0 0 0 0 83 42 0 64 66 0 42 80 0 0 0 0 0 0 0 0 0 0 0 16 28 27 27 27 27 30 83 14 42
56 32 31 24 24 24 24 24 30 56 0 0 0 0 0 0 0 0 0 0 0 82 42 0 64 66 0 42 81 0 0 0 0 0 0 0 0 0 0 0 16 28 27 27 27 27 27 31 35 42
36 28 24 24 24 24 24 24 30 56 0 0 0 0 0 0 0 0 0 0 0 83 42 0 64 66 0 42 80 0 0 0 0 0 0 0 0 0 0 0 16 28 27 27 27 27 27 27 30 42
56 28 24 24 24 24 24 24 30 56 0 0 0 0 0 0 0 0 0 0 0 82 42 0 64 66 0 42 81 0 0 0 0 0 0 0 0 0 0 0 16 28 27 27 27 27 27 27 30 42
36 28 24 24 24 24 24 24 30 56 0 0 0 0 0 0 0 0 0 0 0 83 42 0 64 66 0 42 80 0 0 0 0 0 0 0 0 0 0 0 16 28 27 27 27 27 27 27 30 42
56 28 24 24 24 24 24 24 30 56 0 0 0 0 0 0 0 0 0 0 0 82 42 0 64 66 0 42 81 0 0 0 0 0 0 0 0 0 0 0 16 28 27 27 27 27 27 27 30 42
36 33 29 29 29 29 29 29 34 56 0 0 0 0 0 0 0 0 0 0 0 83 42 0 64 66 0 42 80 0 0 0 0 0 0 0 0 0 0 0 16 33 29 29 29 29 29 29 34 42
56 0 56 56 0 0 56 56 0 0 0 0 0 0 0 0 0 0 0 0 0 82 42 0 64 66 0 42 81 0 0 0 0 0 0 0 0 0 0 0 2 2 16 16 2 2 16 16 2 42
42 0 0 0 0 0 0 0 0 0 0 0 0 0 0 0 0 0 0 0 0 83 42 0 64 66 0 42 80 0 0 0 0 0 0 0 0 0 0 0 0 0 0 0 0 0 0 0 0 42
42 0 0 0 0 0 0 0 0 0 0 0 0 0 0 0 0 0 0 0 0 82 42 0 64 66 0 42 81 0 0 0 0 0 0 0 0 0 0 0 0 0 0 0 0 0 0 0 0 42
42 0 0 0 0 0 0 0 0 0 0 0 0 0 0 0 0 0 0 0 0 83 42 0 64 66 0 42 80 0 0 0 0 0 0 0 0 0 0 0 0 0 0 0 0 0 0 0 0 42
42 0 0 0 0 0 0 0 0 0 0 0 0 0 0 0 0 0 0 0 0 82 42 0 64 66 0 42 81 3 3 3 0 0 0 0 0 0 0 0 0 0 0 0 0 0 0 0 0 42
42 0 0 0 0 0 0 0 0 0 0 0 0 0 0 0 0 0 0 0 82 72 42 0 64 66 0 42 75 81 3 3 0 0 0 0 0 0 0 0 0 0 0 0 0 0 0 0 0 42
42 0 0 0 0 0 0 0 0 0 0 0 0 0 0 0 0 0 0 82 72 16 42 16 69 70 16 42 16 75 81 3 0 0 0 0 0 0 0 0 0 0 0 0 0 0 0 0 0 42
42 81 82 81 82 81 82 81 82 81 82 81 82 81 82 81 82 81 82 72 16 42 41 42 41 41 42 41 42 16 75 81 82 81 82 81 82 81 82 81 82 81 82 81 82 81 82 81 82 42
42 41 41 41 41 41 41 41 41 41 41 41 41 41 41 41 41 41 41 41 41 41 42 41 41 41 41 42 41 41 41 41 41 41 41 41 41 41 41 41 41 41 41 41 41 41 41 41 41 42
42 0 0 0 0 0 0 0 0 0 0 0 0 0 0 0 0 0 0 0 16 42 41 42 41 41 42 41 42 16 0 0 0 0 0 0 0 0 0 0 0 0 0 0 0 0 0 0 0 42
42 68 67 67 67 67 67 67 67 67 67 67 67 67 67 67 67 67 67 67 71 42 42 42 68 71 42 42 42 68 67 67 67 67 67 67 67 67 67 67 67 67 67 67 67 67 67 67 71 42
42 69 65 65 65 65 65 65 65 65 65 65 65 65 65 65 65 65 65 65 70 42 42 42 69 70 42 42 42 69 65 65 65 65 65 65 65 65 65 65 65 65 65 65 65 65 65 65 70 42
42 0 0 0 0 0 0 0 0 0 0 0 0 0 0 0 0 0 0 0 16 42 41 42 41 41 42 41 42 16 0 0 0 0 0 0 0 0 0 0 0 0 0 0 0 0 0 0 0 42
42 41 41 41 41 41 41 41 41 41 41 41 41 41 41 41 41 41 41 41 41 41 42 41 41 41 41 42 41 43 43 43 41 41 41 41 41 41 41 41 41 41 41 41 41 41 41 41 41 42
42 80 83 80 83 80 83 80 83 80 83 80 83 80 83 80 83 80 83 73 16 42 41 42 41 41 42 41 42 16 74 80 83 80 83 80 83 80 83 80 83 80 83 80 83 80 83 80 83 42
42 2 2 2 2 2 2 2 2 2 2 2 2 2 2 2 2 2 2 83 73 16 42 16 68 71 16 42 16 74 80 2 0 0 0 0 0 0 0 0 0 0 0 0 0 0 0 0 0 42
42 0 0 0 0 0 0 0 0 0 0 0 0 0 0 0 0 0 1 1 83 73 42 0 64 66 0 42 74 80 2 2 0 0 0 0 0 0 0 0 0 0 0 0 0 0 0 0 0 42
42 0 0 0 0 0 0 0 0 0 0 0 0 0 0 0 0 0 1 1 1 83 40 2 64 66 2 40 80 2 2 2 0 0 0 0 0 0 0 0 0 0 0 0 0 0 0 0 0 42
42 0 0 0 0 0 0 0 0 0 0 0 0 0 0 0 0 0 0 0 0 82 40 2 64 66 2 40 81 0 0 0 0 0 0 0 0 0 0 0 0 0 0 0 0 0 0 0 0 42
42 0 0 0 0 0 0 0 0 0 0 0 0 0 0 0 0 0 0 0 0 83 40 2 64 66 2 40 80 0 0 0 0 0 0 0 0 0 0 0 0 0 0 0 0 0 0 0 0 42
42 0 0 0 0 0 0 0 0 0 0 0 0 0 0 0 0 0 0 0 0 82 40 2 64 66 2 40 81 0 0 0 0 0 0 0 0 0 0 0 0 0 0 0 0 0 0 0 0 42
42 0 56 56 0 0 56 56 0 0 0 0 0 0 0 0 0 0 0 0 0 83 40 2 64 66 2 40 80 0 0 1 1 0 0 0 0 0 0 0 2 2 16 16 2 2 16 16 2 16
42 32 31 31 31 31 31 31 35 56 0 0 0 0 0 0 0 0 0 0 0 82 40 2 64 66 2 40 81 0 0 0 0 0 0 0 0 0 0 0 16 32 31 31 31 31 31 31 35 38
42 28 25 25 25 25 25 25 30 56 0 0 0 0 0 0 0 0 0 0 0 83 40 2 64 66 2 40 80 0 0 0 0 0 0 0 0 0 0 0 16 28 26 26 26 26 26 26 30 16
42 28 25 25 25 25 25 25 30 56 0 0 0 0 0 0 0 0 0 0 0 82 40 2 64 66 2 40 81 0 0 0 0 0 0 0 0 0 0 0 16 28 26 26 26 26 26 26 30 38
42 28 25 25 25 25 25 25 30 56 0 0 0 0 0 0 0 0 0 0 0 83 40 2 64 66 2 40 80 0 0 0 0 0 0 0 0 0 0 0 16 28 26 26 26 26 26 26 30 16
42 28 25 25 25 25 25 25 30 56 0 0 0 0 0 0 0 0 0 0 0 82 40 2 64 66 2 40 81 0 0 0 0 0 0 0 0 0 0 0 16 28 26 26 26 26 26 26 30 38
42 33 29 25 25 25 25 25 30 56 0 0 0 0 0 0 0 0 0 0 0 83 40 2 64 66 2 40 80 0 0 0 0 0 0 0 0 0 0 0 16 28 26 26 26 26 26 29 34 16
42 12 81 28 25 25 25 25 30 56 0 0 0 0 0 0 0 0 0 0 0 82 40 2 64 66 2 40 81 0 0 0 0 0 0 0 0 0 0 0 16 28 26 26 26 26 30 82 14 38
42 83 12 33 29 29 29 29 34 56 0 0 0 0 0 0 0 0 0 0 0 83 40 2 69 70 2 40 80 0 0 0 0 0 0 0 0 0 0 0 16 33 29 29 29 29 34 13 80 16
60 41 41 41 41 41 41 41 41 41 41 41 41 41 41 41 41 41 41 41 41 41 41 41 41 41 41 41 41 41 41 41 41 41 41 41 41 41 41 41 16 37 16 37 16 37 16 37 16 16