72 72 72 72 72 72 72 72 72 39 39 39 72 80 0 83 72 39 39 39 72 72 72 72 72 72 72 72 72
72 72 72 72 72 72 72 72 72 72 72 72 80 0 0 0 83 72 72 72 72 72 72 72 72 72 72 72 72
72 72 72 72 72 72 72 72 72 72 72 80 0 0 60 0 0 83 72 72 72 72 72 72 72 72 72 72 72
72 72 72 72 72 72 72 72 72 72 80 0 0 0 40 0 0 0 83 72 72 72 72 72 72 72 72 72 72
72 72 72 72 72 76 76 72 72 80 0 0 0 0 40 0 0 0 0 83 72 72 76 76 72 72 72 72 72
72 72 72 72 76 76 76 72 80 0 0 0 0 0 40 0 0 0 0 0 83 72 76 76 76 72 72 72 72
72 72 72 72 76 76 72 80 0 0 0 0 0 0 40 0 0 0 0 0 0 83 72 76 76 72 72 72 72
72 72 72 72 72 72 80 0 0 0 0 0 0 0 40 0 0 0 0 0 0 0 83 72 72 72 72 72 72
72 72 72 72 72 80 0 0 0 0 0 0 0 0 40 0 0 0 0 0 0 0 0 83 72 72 72 72 72
36 72 72 72 80 0 0 0 0 0 0 0 0 56 40 56 0 0 0 0 0 0 0 0 83 72 72 72 38
36 72 72 80 0 0 0 0 0 0 0 0 0 56 40 56 0 0 0 0 0 0 0 0 0 83 72 72 38
36 72 80 0 0 0 0 0 0 0 0 0 0 56 40 56 0 0 0 0 0 0 0 0 0 0 83 72 38
72 80 0 0 0 0 0 0 0 0 0 0 0 0 0 0 0 0 0 0 0 0 0 0 0 0 0 83 72
80 0 0 0 0 0 0 0 0 56 56 56 0 68 67 71 0 56 56 56 0 0 0 0 0 0 0 0 83
0 0 60 41 41 41 41 41 41 41 41 41 0 64 84 66 0 41 41 41 41 41 41 41 41 41 60 0 0
81 0 0 0 0 0 0 0 0 56 56 56 0 69 65 70 0 56 56 56 0 0 0 0 0 0 0 0 82
72 81 0 0 0 0 0 0 0 0 0 0 0 0 0 0 0 0 0 0 0 0 0 0 0 0 0 82 72
36 72 81 0 0 0 0 0 0 0 0 0 0 56 40 56 0 0 0 0 0 0 0 0 0 0 82 72 38
36 72 72 81 0 0 0 0 0 0 0 0 0 56 40 56 0 0 0 0 0 0 0 0 0 82 72 72 38
36 72 72 72 81 0 0 0 0 0 0 0 0 56 40 56 0 0 0 0 0 0 0 0 82 72 72 72 38
72 72 72 72 72 81 0 0 0 0 0 0 0 0 40 0 0 0 0 0 0 0 0 82 72 72 72 72 72
72 72 72 72 72 72 81 0 0 0 0 0 0 0 40 0 0 0 0 0 0 0 82 72 72 72 72 72 72
72 72 72 72 76 76 72 81 0 0 0 0 0 0 40 0 0 0 0 0 0 82 72 76 76 72 72 72 72
72 72 72 72 76 76 76 72 81 0 0 0 0 0 40 0 0 0 0 0 82 72 76 76 76 72 72 72 72
72 72 72 72 72 76 76 72 72 81 0 0 0 0 40 0 0 0 0 82 72 72 76 76 72 72 72 72 72
72 72 72 72 72 72 72 72 72 72 81 0 0 0 40 0 0 0 82 72 72 72 72 72 72 72 72 72 72
72 72 72 72 72 72 72 72 72 72 72 81 0 0 60 0 0 82 72 72 72 72 72 72 72 72 72 72 72
72 72 72 72 72 72 72 72 72 72 72 72 81 0 0 0 82 72 72 72 72 72 72 72 72 72 72 72 72
72 72 72 72 72 72 72 72 72 37 37 37 72 81 0 82 72 37 37 37 72 72 72 72 72 72 72 72 72