16 16 16 16 16 16 16 16 16 16 16 16 16 16 16 16 16 16 16 16 16 16 16 16 16 16 16 16 16 16 16 16 16 16 16 39 39 39 39 39
16 16 16 16 16 16 16 16 16 16 16 16 16 16 16 16 16 16 16 16 16 16 16 16 16 16 16 16 16 16 16 16 16 16 16 16 15 15 15 15
16 16 40 41 41 41 41 41 41 41 41 41 41 41 41 41 41 41 41 41 41 41 41 41 41 41 41 41 41 41 41 41 41 41 40 16 15 42 15 16
16 16 42 16 16 16 40 16 40 16 16 16 16 16 16 16 40 16 16 16 16 42 16 16 16 16 16 16 16 16 16 16 16 16 42 16 15 42 15 16
16 16 42 16 16 16 40 16 40 16 16 16 16 16 16 16 40 16 16 16 16 42 16 16 16 16 16 16 16 16 16 16 16 16 42 16 16 42 15 16
16 16 42 16 16 16 40 16 40 16 16 16 16 16 16 16 40 16 16 16 16 42 16 16 16 16 16 16 16 16 16 16 16 16 42 41 41 42 16 16
16 16 42 16 16 16 40 16 40 16 16 16 16 16 16 16 40 16 16 16 16 42 16 16 16 16 16 16 16 16 16 16 16 16 42 16 16 60 16 16
16 16 42 16 16 16 40 16 40 16 16 16 16 16 16 16 40 16 16 16 16 42 16 16 16 16 16 16 16 16 16 16 16 16 42 41 41 42 16 16
16 16 42 16 16 16 40 16 40 16 16 16 16 16 16 16 40 16 16 16 16 42 16 16 16 16 16 16 16 16 16 16 16 16 42 16 16 42 16 16
16 16 42 16 16 16 40 16 40 16 16 16 16 16 16 16 40 16 16 16 16 42 16 16 16 16 16 16 16 16 16 16 16 16 42 16 16 42 16 16
16 16 40 41 41 41 42 41 42 41 41 41 41 41 41 41 42 41 41 41 41 43 41 41 41 41 41 41 41 41 41 41 16 16 42 16 16 42 16 16
16 16 42 16 16 16 40 16 40 16 16 16 16 16 16 16 42 16 16 16 16 16 16 16 16 16 16 16 16 16 16 42 16 16 42 16 16 42 16 16
16 16 42 16 16 16 40 16 40 16 16 16 16 16 16 16 42 16 16 16 16 16 16 16 16 16 16 16 16 16 16 42 16 16 42 16 16 42 16 16
16 16 42 16 16 16 40 16 40 16 16 16 16 16 16 16 42 16 16 16 16 16 16 16 16 16 16 16 16 16 16 42 16 16 42 16 16 42 16 16
16 16 42 16 16 16 40 16 40 16 16 16 16 16 16 16 42 16 16 16 16 16 16 16 16 16 16 16 16 16 16 42 16 16 42 16 16 42 16 16
16 16 42 16 16 16 40 16 40 16 16 16 16 16 16 16 42 16 16 16 16 16 16 16 16 16 16 16 16 16 16 42 16 16 42 16 16 42 16 16
16 16 42 16 16 16 40 16 40 16 16 16 16 16 16 16 42 16 16 16 16 16 16 16 16 16 16 16 16 16 16 42 16 16 42 16 16 42 16 16
16 16 42 16 16 16 40 16 40 16 16 16 16 16 16 16 42 16 16 16 16 16 16 16 16 16 16 16 16 16 16 42 16 16 42 16 16 42 16 16
16 16 42 16 16 16 40 16 40 16 16 16 16 16 16 16 42 16 16 16 16 16 16 16 16 16 16 16 16 16 16 42 16 16 42 16 16 42 16 16
16 16 42 16 16 16 40 16 40 16 16 16 16 16 16 16 42 16 16 16 16 16 16 16 16 16 16 16 16 16 16 42 16 16 42 16 16 42 16 16
16 16 42 16 16 16 40 16 40 16 16 16 16 16 16 16 40 16 16 16 16 16 16 16 16 16 16 16 16 16 16 42 16 16 42 16 16 42 16 16
16 16 40 41 41 41 43 41 43 41 41 41 41 41 41 41 42 41 41 41 41 41 41 41 41 41 41 41 41 41 41 40 41 41 41 41 41 42 16 16
16 16 42 16 16 16 40 16 40 16 16 16 16 16 16 16 40 16 16 16 16 16 16 16 16 16 16 16 16 16 16 42 16 16 42 16 16 42 16 16
16 16 42 16 16 16 40 16 40 16 16 16 16 16 16 16 40 16 16 16 16 16 16 16 16 16 16 16 16 16 16 42 16 16 42 16 16 42 16 16
16 16 42 16 16 16 40 16 40 16 16 16 16 16 16 16 40 16 16 16 16 16 16 16 16 16 16 16 16 16 16 42 16 16 42 16 16 42 16 16
16 16 42 16 16 16 40 16 40 16 16 16 16 16 16 16 40 16 16 16 16 16 16 16 16 16 16 16 16 16 16 42 16 16 42 16 16 42 16 16
16 16 42 16 16 16 40 16 40 16 16 16 16 16 16 16 40 16 16 16 16 16 16 16 16 16 16 16 16 16 16 42 16 16 42 16 16 42 16 16
16 16 42 16 16 16 40 16 40 16 16 16 16 16 16 16 40 16 16 16 16 16 16 16 16 16 16 16 16 16 16 42 16 16 42 16 16 42 16 16
16 16 42 16 16 16 40 16 40 16 16 16 16 16 16 16 40 16 16 16 16 16 16 16 16 16 16 16 16 16 16 42 16 16 42 16 16 42 16 16
16 16 42 16 16 16 40 16 42 41 41 41 41 41 41 41 43 41 41 41 41 41 41 41 41 41 41 41 41 41 41 40 16 16 42 16 16 42 16 16
16 16 42 16 16 16 40 16 40 16 16 16 16 16 16 16 16 16 16 16 16 16 16 16 16 16 16 16 16 16 16 42 16 16 42 16 16 42 16 16
16 16 42 16 16 16 40 16 40 16 16 16 16 16 16 16 16 16 16 16 16 16 16 16 16 16 16 16 16 16 16 42 16 16 42 16 16 42 16 16
16 16 42 41 41 41 40 41 41 41 41 41 41 41 41 41 41 41 41 41 41 41 41 41 41 41 41 41 41 41 41 43 41 41 42 41 41 42 16 16
16 16 60 16 16 16 40 16 16 16 16 16 16 16 16 16 16 16 16 40 16 16 16 16 16 16 16 16 16 16 16 16 16 16 42 16 16 42 16 16
16 16 40 41 41 41 40 16 16 16 16 16 16 16 16 16 16 16 16 40 16 16 16 16 16 16 16 16 16 16 16 16 16 16 42 16 16 42 16 16
16 13 42 16 16 16 40 16 16 16 16 16 16 16 16 16 16 16 16 40 16 16 16 16 16 16 16 16 16 16 16 16 16 16 42 16 16 42 16 16
16 13 42 13 16 16 40 16 16 16 16 16 16 16 16 16 16 16 16 40 16 16 16 16 16 16 16 16 16 16 16 16 16 16 42 16 16 42 16 16
16 13 42 13 16 16 40 41 41 41 41 41 41 41 41 41 41 41 41 41 41 41 41 41 41 41 41 41 41 41 41 41 41 41 41 41 41 40 16 16
13 13 13 13 16 16 16 16 16 16 16 16 16 16 16 16 16 16 16 16 16 16 16 16 16 16 16 16 16 16 16 16 16 16 16 16 16 16 16 16
37 37 37 37 37 16 16 16 16 16 16 16 16 16 16 16 16 16 16 16 16 16 16 16 16 16 16 16 16 16 16 16 16 16 16 16 16 16 16 16