12 0 0 0 0 0 0 0 0 0 0 0 0 0 0 0 0 0 0 0 0 0 0 0 0 0 0 84 84 84 84 84 0 0 0 0 0 0 0 0 0 0 0 0 0 0 0 0 0 0 0 0 0 0 0 0 0 0 0 0 0 0 14
12 0 0 0 0 0 0 0 0 0 0 0 0 0 0 0 0 0 0 0 0 0 0 0 0 0 0 84 84 84 84 84 0 0 0 0 0 0 0 0 0 0 0 0 0 0 0 0 0 0 0 0 0 0 0 0 0 0 0 0 0 0 14
12 0 0 0 0 0 0 0 0 0 0 0 0 0 0 0 56 0 0 0 0 0 0 0 0 0 0 84 84 84 84 84 0 0 0 0 0 0 0 0 0 0 0 0 0 0 0 0 0 0 0 0 0 0 0 0 0 0 0 0 0 0 14
12 0 0 0 0 0 0 16 0 0 0 0 0 0 0 0 0 0 0 0 0 0 0 0 0 0 16 84 84 84 84 84 56 0 0 0 0 0 0 0 0 56 0 0 0 0 0 0 0 0 0 0 0 0 0 0 0 0 0 0 0 0 14
12 0 0 0 0 0 0 36 0 0 0 0 0 0 0 0 0 0 0 0 0 0 0 0 0 0 0 41 41 41 41 41 0 0 0 0 0 0 0 0 0 0 56 0 0 0 0 56 0 0 0 0 0 0 0 0 0 0 0 0 0 0 14
12 0 0 0 0 0 0 36 0 0 0 0 0 0 0 0 0 0 0 0 0 0 0 0 0 0 0 41 41 41 41 41 0 0 0 0 0 0 0 0 0 0 0 0 0 0 0 0 0 0 0 0 0 0 0 0 0 0 0 0 0 0 14
12 0 0 0 0 0 0 16 0 0 0 0 0 0 0 0 0 0 0 0 0 0 0 0 0 0 16 84 84 84 84 84 56 0 0 0 0 0 0 0 0 0 0 0 0 0 0 0 0 0 0 0 0 0 0 0 0 0 0 0 0 0 14
12 0 0 0 0 0 0 0 0 0 0 0 0 0 0 0 56 0 0 0 0 0 0 0 0 0 16 84 84 84 84 84 56 0 0 0 0 0 0 0 0 0 0 0 0 0 0 0 0 0 0 0 0 0 38 56 0 0 0 0 0 0 14
12 0 0 0 0 0 0 0 0 0 0 0 0 0 0 0 0 0 0 0 0 0 0 0 0 0 16 84 84 84 84 84 56 0 0 0 0 0 0 0 0 0 0 0 0 0 0 0 0 0 0 0 0 0 0 56 37 0 0 0 0 0 14
12 0 0 0 0 0 0 0 0 0 0 0 0 0 0 0 0 0 0 0 0 0 0 0 0 0 16 84 84 84 84 84 56 0 0 0 0 0 0 0 0 0 0 0 0 0 0 0 0 0 0 0 0 0 38 56 0 0 0 0 0 0 14
36 0 0 0 0 0 0 0 0 0 0 0 0 0 0 0 0 0 0 0 0 0 16 16 16 16 16 84 84 84 84 84 56 0 0 0 0 0 0 0 0 0 0 0 0 0 0 0 0 0 0 0 0 0 0 56 37 0 0 0 0 0 14
12 0 0 0 0 16 16 41 41 41 41 41 41 41 41 41 41 41 41 41 41 41 41 41 41 42 84 84 84 84 84 84 14 31 31 31 31 31 31 31 31 35 0 0 0 0 0 0 0 0 0 0 0 0 38 56 0 0 0 0 0 0 14
12 0 0 0 16 16 42 41 41 41 41 41 41 41 41 41 41 41 41 41 41 41 41 41 42 42 84 84 84 84 84 84 14 24 24 24 24 24 24 24 24 30 0 0 0 0 0 0 0 0 0 0 0 0 0 56 37 0 0 0 0 0 14
12 0 0 0 16 42 42 42 41 41 41 41 41 41 41 41 41 41 41 41 41 41 41 42 42 42 84 84 84 84 84 84 14 24 24 24 24 24 24 24 24 24 56 56 56 56 56 56 0 0 0 0 0 0 38 56 0 0 0 0 0 0 14
36 0 0 0 0 42 42 42 0 0 0 0 0 0 0 0 12 12 12 12 12 12 12 42 42 42 16 84 84 84 84 84 56 24 24 24 24 24 24 24 24 24 24 24 24 24 24 56 0 0 0 0 0 0 0 0 0 0 0 0 0 0 14
12 0 0 0 0 42 42 42 0 0 0 0 0 0 0 0 12 24 24 24 24 24 16 42 42 42 16 84 84 84 84 84 56 24 24 24 24 24 24 24 24 24 24 24 24 24 24 56 37 0 0 0 0 0 0 0 0 0 0 0 0 0 14
12 0 0 0 0 42 42 42 0 0 0 0 0 0 0 0 12 24 24 24 24 24 16 42 42 42 16 84 84 84 84 84 56 24 24 24 24 24 24 24 24 24 24 24 24 24 24 56 0 0 0 0 0 0 0 38 0 0 38 0 0 0 38
12 0 0 0 0 42 42 42 0 0 0 0 0 0 36 0 12 24 24 24 24 24 16 42 42 42 16 84 84 84 16 16 56 16 16 16 16 16 16 16 24 24 24 24 24 24 24 56 0 0 0 0 0 0 0 56 56 56 56 0 0 0 14
12 0 0 0 0 42 42 42 0 0 0 16 16 16 16 16 16 24 24 24 24 24 16 42 42 42 16 84 84 84 16 41 41 41 41 41 41 41 41 41 42 24 24 24 24 24 24 14 0 0 0 0 0 0 0 56 42 39 42 0 0 0 14
12 0 0 0 0 42 42 42 0 0 0 0 0 0 0 39 16 24 24 24 24 24 16 42 42 42 16 84 84 16 41 41 41 41 41 41 41 41 41 42 42 24 24 24 24 24 24 14 0 0 0 0 0 0 0 0 42 42 42 0 0 0 38
12 0 0 0 0 42 60 42 0 0 0 0 0 0 0 0 16 24 24 24 24 24 16 42 42 42 16 14 16 14 14 14 14 14 14 56 14 56 42 42 42 56 24 24 24 24 24 56 0 0 0 0 0 0 0 0 42 60 42 0 0 0 14
36 0 0 0 0 42 42 42 0 0 0 0 0 0 0 0 12 24 24 24 24 24 24 42 42 41 41 41 41 41 41 41 41 41 56 84 84 56 42 42 42 56 24 24 24 24 24 56 37 0 0 0 0 0 0 0 42 42 42 0 0 0 14
12 0 0 0 0 42 37 42 16 0 0 0 0 0 0 0 12 24 24 24 24 24 24 42 41 41 41 41 41 41 41 41 41 56 84 84 84 56 42 42 42 56 24 24 24 24 24 56 56 56 56 56 56 0 0 0 42 42 42 0 0 0 14
12 0 0 0 0 16 16 16 16 0 0 0 0 0 0 0 16 24 24 24 24 24 24 24 56 56 56 56 56 56 56 16 56 56 84 84 84 56 42 42 42 56 24 24 24 24 24 14 0 0 0 0 0 0 0 0 42 42 42 0 0 0 14
36 0 0 0 0 36 0 0 36 0 0 0 0 0 0 0 16 24 24 24 24 24 24 24 24 24 24 24 24 24 24 16 84 84 84 84 84 56 42 42 42 56 24 24 24 24 24 14 0 0 0 0 0 0 0 0 42 42 42 0 0 0 14
12 0 0 0 0 0 0 0 0 0 0 0 0 0 0 39 16 24 24 24 24 24 24 24 24 24 24 24 24 24 24 16 84 84 84 84 84 56 42 42 42 56 24 24 24 24 24 14 0 0 0 0 0 0 0 0 42 42 42 0 0 0 14
12 0 0 0 0 0 0 0 0 0 0 0 0 0 0 0 16 24 24 24 24 24 24 24 24 24 24 24 24 24 24 16 84 84 84 84 84 56 42 42 42 14 14 14 14 14 14 14 0 0 0 0 0 0 0 0 42 42 42 0 0 0 38
12 0 0 0 0 0 0 0 16 36 0 0 0 0 0 0 16 16 16 16 16 16 24 24 24 24 24 24 24 24 24 12 84 84 84 84 84 84 42 42 42 41 41 41 41 41 41 41 41 41 41 41 41 41 41 41 42 42 42 56 0 0 14
12 0 0 0 0 0 0 39 16 0 0 0 0 0 0 0 0 0 0 0 0 0 28 24 24 24 24 24 24 24 24 12 84 84 84 84 84 84 42 42 41 41 41 41 41 41 41 41 41 41 41 41 41 41 41 41 41 42 56 56 0 0 14
12 0 0 0 0 0 0 0 16 36 0 0 0 0 0 0 0 0 0 0 0 0 33 29 29 29 29 29 29 29 29 12 84 84 84 84 84 84 42 41 41 41 41 41 41 41 41 41 41 41 41 41 41 41 41 41 41 56 56 0 0 0 14
12 0 0 0 0 0 0 39 16 0 0 0 0 0 0 0 0 0 0 0 0 0 0 0 0 0 0 0 0 0 0 16 84 84 84 84 84 56 56 56 56 56 0 0 0 0 0 0 0 0 0 0 0 0 0 0 0 0 0 0 0 0 38
12 0 0 0 0 0 0 0 16 36 0 0 0 0 0 0 0 0 0 0 0 0 0 0 0 0 0 0 0 0 0 16 84 84 84 84 84 56 0 0 0 0 0 0 0 0 0 0 0 0 0 0 0 0 0 0 0 0 0 0 0 0 14
12 0 0 0 0 0 0 39 16 0 0 0 0 0 0 0 0 0 0 0 0 0 0 0 0 0 0 0 0 0 0 16 84 84 84 84 84 56 0 0 0 0 0 0 0 0 0 0 0 0 0 0 0 0 0 0 0 0 0 0 0 0 14
12 0 0 0 0 0 0 0 16 36 0 0 0 0 0 0 0 0 0 0 0 0 0 0 0 0 0 0 0 0 0 16 84 84 84 84 84 56 0 0 0 0 0 0 0 0 0 56 0 0 0 0 0 0 0 0 0 0 0 0 0 0 14
12 0 0 0 0 0 0 0 0 0 0 0 0 0 0 0 0 0 0 0 0 0 0 0 0 0 0 0 0 0 0 16 84 84 84 84 84 56 0 0 0 0 0 0 0 0 0 0 0 0 0 0 0 0 0 0 56 0 0 0 0 0 14
12 0 0 0 0 0 0 0 0 0 0 0 0 0 0 0 0 0 0 0 0 0 0 0 0 0 0 0 0 0 0 0 41 41 41 41 41 0 0 0 0 0 0 0 0 0 0 0 0 0 0 0 0 0 0 0 38 0 0 0 0 0 14
12 0 0 0 0 0 0 0 0 0 0 0 0 0 0 0 16 0 0 0 0 16 0 0 0 0 0 0 0 0 0 0 41 41 41 41 41 0 0 0 0 0 0 0 0 0 0 0 0 0 0 0 0 0 0 0 38 0 0 0 0 0 14
12 0 0 0 0 0 0 0 0 0 0 0 0 0 0 0 0 0 0 0 0 0 16 0 0 0 0 0 0 0 0 16 84 84 84 84 84 56 0 0 0 0 0 0 0 0 0 0 0 0 0 0 0 0 0 0 56 0 0 0 0 0 14
12 0 0 0 0 0 0 0 0 0 0 0 0 0 0 0 0 0 0 0 0 0 0 0 0 0 0 0 0 0 0 0 84 84 84 84 84 0 0 0 0 0 0 0 0 0 0 56 0 0 0 0 0 0 0 0 0 0 0 0 0 0 14
12 0 0 0 0 0 0 0 0 0 0 0 0 0 0 0 0 0 0 0 0 0 0 0 0 0 0 0 0 0 0 0 84 84 84 84 84 0 0 0 0 0 0 0 0 0 0 0 0 0 0 0 0 0 0 0 0 0 0 0 0 0 14
12 0 0 0 0 0 0 0 0 0 0 0 0 0 0 0 0 0 0 0 0 0 0 0 0 0 0 0 0 0 0 0 84 84 84 84 84 0 0 0 0 0 0 0 0 0 0 0 0 0 0 0 0 0 0 0 0 0 0 0 0 0 14