84 84 84 16 84 84 84 84 84 84 84 16 84 84
84 84 84 16 84 84 84 84 84 84 84 16 84 84
84 84 84 36 24 24 24 24 24 24 24 38 84 84
84 84 84 36 24 24 24 60 24 24 24 38 84 84
84 84 84 36 24 24 24 24 24 24 24 38 84 84
84 84 84 36 24 24 24 24 24 24 24 38 84 84
84 84 84 36 24 24 24 24 24 24 24 38 84 84
84 84 84 16 24 24 24 24 24 24 24 16 84 84
84 84 84 84 24 24 24 24 24 24 24 84 84 84
84 84 84 84 24 24 24 24 24 24 24 84 84 84
84 84 84 84 24 24 24 24 24 24 24 84 84 84
84 84 84 84 24 24 24 24 24 24 24 84 84 84
84 84 84 84 24 24 24 24 24 24 24 84 84 84
84 84 84 84 24 24 24 24 24 24 24 84 84 84
84 84 84 16 24 24 24 24 24 24 24 16 84 84
84 84 84 36 24 24 24 24 24 24 24 38 84 84
84 84 84 36 24 24 24 24 24 24 24 38 84 84
84 84 84 36 24 24 24 24 24 24 24 38 84 84
84 84 84 36 24 24 24 60 24 24 24 38 84 84
84 84 84 36 24 24 24 24 24 24 24 38 84 84
84 84 84 16 84 84 84 84 84 84 84 16 84 84
84 84 84 16 84 84 84 84 84 84 84 16 84 84