16 16 0 0 0 0 0 0 0 0 0 0 0 0 42 0 0 0 0 0 0 0 0 0 0 83 72 72 72 72 72 72 72 72 72 42 72 72 72 72 72 72 72 72 72 72 72 72 56 56
16 16 16 16 16 16 16 0 0 0 0 0 0 0 42 41 41 41 41 41 41 41 41 41 41 41 41 41 41 41 41 41 41 41 41 42 72 72 72 72 72 72 72 56 56 56 56 56 56 56
36 0 0 0 16 16 16 0 0 0 0 0 0 0 42 16 16 16 16 16 16 16 16 16 16 56 56 56 56 56 56 56 56 56 56 42 72 72 72 72 72 72 72 56 56 56 72 72 72 38
16 0 0 0 0 16 16 16 0 0 0 0 0 0 42 32 31 31 31 31 31 31 31 31 31 31 31 31 31 31 31 31 31 31 35 42 72 72 72 72 72 72 56 56 56 72 72 72 72 56
36 0 0 0 0 0 16 16 0 0 0 0 0 0 42 28 24 24 24 24 24 24 24 24 24 24 24 24 24 24 24 24 24 24 30 42 72 72 72 72 72 72 56 56 72 72 72 72 72 38
16 0 0 0 0 0 0 0 0 0 0 0 0 0 42 28 24 24 24 24 24 24 24 29 29 29 29 24 24 24 24 24 24 24 30 42 72 72 72 72 72 72 72 72 72 72 72 72 72 56
36 0 0 0 0 0 0 0 0 0 0 0 0 0 42 28 24 24 24 24 24 24 30 68 67 67 71 28 24 24 24 24 24 24 30 42 72 72 72 72 72 72 72 72 72 72 72 72 72 38
16 0 0 0 0 0 16 0 0 0 0 0 0 0 42 28 24 24 24 24 24 24 30 64 84 84 66 28 24 24 24 24 24 24 30 42 72 72 72 72 72 72 72 56 72 72 72 72 72 56
36 0 0 0 0 0 16 0 0 0 0 0 0 0 42 28 24 24 24 24 24 24 30 64 84 84 66 28 24 24 24 24 24 24 30 42 72 72 72 72 72 72 72 56 72 72 72 72 72 38
16 0 0 0 0 0 16 0 0 0 0 0 0 0 42 28 24 24 24 24 24 24 30 64 84 84 66 28 24 24 24 24 24 24 30 42 72 72 72 72 72 72 72 56 72 72 72 72 72 56
36 0 0 0 0 0 16 16 0 0 0 0 0 0 42 28 24 24 24 24 24 24 30 64 84 84 66 28 24 24 24 24 24 24 30 42 72 72 72 72 72 72 56 56 72 72 72 72 72 38
16 0 0 0 0 0 0 0 0 0 0 0 0 0 42 28 24 24 24 24 24 24 30 64 84 84 66 28 24 24 24 24 24 24 30 42 72 72 72 72 72 72 72 72 72 72 72 72 72 56
36 0 0 0 0 0 0 0 0 0 0 0 0 0 42 28 24 24 24 24 24 24 30 64 84 84 66 28 24 24 24 24 24 24 30 42 72 72 72 72 72 72 72 72 72 72 72 72 72 38
16 0 0 0 0 0 0 0 0 0 0 0 0 0 42 28 24 24 24 24 24 24 30 64 84 84 66 28 24 24 24 24 24 24 30 42 72 72 72 72 72 72 72 72 72 72 72 72 72 56
36 0 0 0 0 16 0 16 0 0 0 16 0 16 42 28 24 24 24 24 24 24 30 69 65 65 70 28 24 24 24 24 24 24 30 42 56 72 56 72 72 72 56 72 56 72 72 72 72 38
16 0 0 0 0 16 16 16 12 12 12 16 16 16 42 28 24 24 24 24 24 24 24 31 31 31 31 24 24 24 24 24 24 24 30 42 56 56 56 12 12 12 56 56 56 72 72 72 72 56
36 0 0 0 0 0 16 12 12 12 12 12 16 0 42 33 29 29 29 29 29 29 29 29 29 29 29 29 29 29 29 29 29 29 34 42 72 56 12 12 12 12 12 56 72 72 72 72 72 38
16 0 0 0 0 0 16 12 12 12 12 12 16 0 42 41 41 41 41 41 41 41 41 41 41 41 41 41 41 41 41 41 41 41 41 42 72 56 12 12 12 12 12 56 72 72 72 72 72 56
36 0 0 0 0 0 16 12 12 62 12 12 16 0 42 0 0 0 0 0 0 0 0 0 0 83 72 72 72 72 72 72 72 72 72 42 74 56 12 12 62 12 12 56 72 74 74 74 74 38
16 0 0 0 0 0 16 12 12 12 12 12 16 0 42 41 41 41 41 41 41 41 41 41 41 41 41 41 41 41 41 41 41 41 41 42 74 56 12 12 12 12 12 56 72 74 74 74 74 56
36 0 0 0 0 0 16 12 12 12 12 12 16 0 42 32 31 31 31 31 31 31 31 31 31 31 31 31 31 31 31 31 31 31 35 42 74 56 12 12 12 12 12 56 72 74 74 74 74 38
16 0 0 0 0 16 16 16 12 12 12 16 16 16 42 28 24 24 24 24 24 24 24 29 29 29 29 24 24 24 24 24 24 24 30 42 56 56 56 12 12 12 56 56 56 74 74 74 74 56
36 0 0 0 0 16 0 16 0 0 0 16 0 16 42 28 24 24 24 24 24 24 30 68 67 67 71 28 24 24 24 24 24 24 30 42 56 74 56 72 72 72 56 74 56 74 74 74 74 38
16 0 0 0 0 0 0 0 0 0 0 0 0 0 42 28 24 24 24 24 24 24 30 64 84 84 66 28 24 24 24 24 24 24 30 42 74 74 74 74 74 74 74 74 74 74 74 74 74 56
36 0 0 0 0 0 0 0 0 0 0 0 0 0 42 28 24 24 24 24 24 24 30 64 84 84 66 28 24 24 24 24 24 24 30 42 74 74 74 74 74 74 74 74 74 74 74 74 74 38
16 0 0 0 0 0 0 0 0 0 0 0 0 0 42 28 24 24 24 24 24 24 30 64 84 84 66 28 24 24 24 24 24 24 30 42 74 74 74 74 74 74 74 74 74 74 74 74 74 56
36 0 0 0 0 0 16 16 0 0 0 0 0 0 42 28 24 24 24 24 24 24 30 64 84 84 66 28 24 24 24 24 24 24 30 42 74 74 74 74 74 74 56 56 74 74 74 74 74 38
16 2 2 2 2 2 16 2 0 0 0 0 0 0 42 28 24 24 24 24 24 24 30 64 84 84 66 28 24 24 24 24 24 24 30 42 74 74 74 74 74 74 74 56 74 74 74 74 74 56
36 2 2 2 2 2 16 2 0 0 0 0 0 0 42 28 24 24 24 24 24 24 30 64 84 84 66 28 24 24 24 24 24 24 30 42 74 74 74 74 74 74 74 56 74 74 74 74 74 38
16 2 2 2 2 2 16 2 0 0 0 0 0 0 42 28 24 24 24 24 24 24 30 64 84 84 66 28 24 24 24 24 24 24 30 42 74 74 74 74 74 74 74 56 74 74 74 74 74 56
36 2 2 2 2 2 2 2 0 0 0 0 0 0 42 28 24 24 24 24 24 24 30 69 65 65 70 28 24 24 24 24 24 24 30 42 74 74 74 74 74 74 74 74 74 74 74 74 74 38
16 2 2 2 2 2 2 2 0 0 0 0 0 0 42 28 24 24 24 24 24 24 24 31 31 31 31 24 24 24 24 24 24 24 30 42 74 74 74 74 74 74 74 74 74 74 74 74 74 56
36 2 2 2 2 2 16 16 0 0 0 0 0 0 42 28 24 24 24 24 24 24 24 24 24 24 24 24 24 24 24 24 24 24 30 42 74 74 74 74 74 74 56 56 74 74 74 74 74 38
16 2 2 2 2 16 16 16 0 0 0 0 0 0 42 33 29 29 29 29 29 29 29 29 29 29 29 29 29 29 29 29 29 29 34 42 74 74 74 74 74 74 56 56 56 74 74 74 74 56
36 2 2 2 16 16 16 2 0 0 0 0 0 0 42 16 16 16 16 16 16 16 16 16 16 56 56 56 56 56 56 56 56 56 56 42 74 74 74 74 74 74 74 56 56 56 74 74 74 38
16 16 16 16 16 16 16 2 0 0 0 0 0 0 42 41 41 41 41 41 41 41 41 41 41 41 41 41 41 41 41 41 41 41 41 42 74 74 74 74 74 74 74 56 56 56 56 56 56 56
16 16 2 2 2 2 2 2 0 0 0 0 0 0 42 0 0 0 0 0 0 0 0 0 0 82 72 72 72 72 72 72 72 72 72 42 74 74 74 74 74 74 74 74 74 74 74 74 56 56