0 3 1 0 0 0 2 0 2 3 3 0 1 0 3 0 2 1 3 0 1 1 0 0 1 0 2 1 0 2 1 3 1 0 0 2 2 1 1 1 3 2 0 3 1 2 3 2 3 3 0 0 2 0 2
2 0 1 3 1 2 1 0 3 0 1 3 2 1 3 0 1 3 0 3 2 1 1 0 3 3 3 0 0 2 0 2 3 0 1 3 2 3 1 2 3 3 1 2 3 1 2 3 1 3 3 2 2 2 1
0 0 1 3 3 0 1 2 3 3 0 2 3 2 2 2 1 2 3 3 3 3 2 1 0 3 0 0 1 2 1 1 1 1 2 2 1 3 3 2 2 3 3 3 2 0 1 0 1 1 2 2 2 0 1
0 2 1 1 0 0 2 2 12 36 36 36 12 0 3 1 3 0 3 1 3 3 2 2 0 2 1 56 3 1 0 1 1 3 3 3 0 2 2 0 1 0 14 38 38 38 14 1 1 1 2 1 3 3 1
3 0 0 0 2 0 2 0 12 36 36 36 12 0 1 1 0 3 0 0 0 2 3 3 0 3 2 56 1 2 3 3 2 2 2 2 3 0 0 3 0 3 14 38 38 38 14 1 1 0 0 2 2 2 1
1 2 0 3 1 2 0 2 3 2 3 3 0 0 3 3 2 0 0 2 1 3 3 0 1 2 2 1 2 0 2 2 2 1 1 3 1 2 0 3 1 2 2 1 3 2 0 1 0 1 1 0 0 2 2
2 2 2 0 2 68 67 67 67 67 67 67 67 67 67 71 3 3 3 2 1 0 3 0 2 3 2 1 1 1 2 3 2 0 3 3 2 0 0 68 67 67 67 67 67 67 67 67 67 71 1 1 3 2 3
3 2 1 2 0 64 85 65 65 65 65 65 65 65 84 66 1 0 1 1 3 0 1 2 3 2 1 0 0 1 1 2 3 0 0 0 3 0 2 64 86 65 65 65 65 65 65 65 84 66 0 1 2 1 3
3 0 2 3 0 64 66 16 16 16 16 16 16 16 64 66 16 0 1 3 3 1 2 0 1 1 1 2 2 3 2 0 3 2 2 2 2 3 16 64 66 16 16 16 16 16 16 16 64 66 2 2 0 2 3
0 1 1 3 2 64 66 16 4 6 4 4 5 41 41 41 41 1 1 0 1 3 2 2 0 3 3 0 3 1 0 3 2 1 0 0 2 2 43 43 43 43 4 5 7 7 4 16 64 66 2 1 2 3 3
3 2 3 2 2 64 66 16 4 5 5 5 6 41 41 41 41 2 3 3 1 0 1 2 1 1 2 0 3 0 1 0 1 0 2 3 2 2 43 43 43 43 5 5 7 4 6 16 64 66 2 1 0 3 1
0 3 0 1 3 64 66 16 7 4 60 7 7 16 64 66 16 2 3 3 3 3 2 0 2 0 1 56 3 0 2 3 1 3 1 2 1 2 16 64 66 16 5 4 60 4 4 16 64 66 0 0 1 3 0
3 1 2 0 1 64 66 16 4 5 4 5 6 41 41 41 41 1 2 3 1 0 3 0 3 1 2 0 1 3 1 2 0 0 1 2 2 1 43 43 43 43 4 7 5 4 7 16 64 66 2 2 1 0 1
1 2 1 3 2 64 66 16 5 5 7 7 5 41 41 41 41 2 1 3 1 1 2 3 1 0 0 3 0 2 0 1 0 3 1 2 1 0 43 43 43 43 7 5 7 6 6 16 64 66 3 0 1 1 1
2 1 1 0 3 64 66 16 16 16 16 16 16 16 64 66 16 0 2 0 1 1 1 0 3 0 2 1 2 2 3 1 1 1 0 2 2 2 16 64 66 16 16 16 16 16 16 16 64 66 3 1 0 1 1
1 1 3 2 2 64 86 67 67 67 67 67 67 67 84 66 3 2 0 3 2 2 1 1 2 0 3 0 3 0 3 0 1 1 2 2 0 1 1 64 86 67 67 67 67 67 67 67 87 66 2 2 1 0 1
0 2 2 2 1 69 65 65 65 65 65 65 65 65 65 70 1 2 1 1 2 3 0 1 1 0 2 3 3 0 0 3 1 3 1 2 3 1 2 69 65 65 65 65 65 65 65 65 65 70 2 3 0 2 1
3 2 1 2 2 1 3 2 3 1 3 3 1 0 1 0 1 1 2 0 2 3 0 3 1 2 1 2 2 0 1 1 1 1 2 0 2 0 1 3 3 0 0 1 2 3 2 0 0 0 3 1 0 2 0
1 0 1 1 2 2 1 1 12 36 36 36 12 0 3 0 1 3 3 3 3 3 3 0 2 0 0 56 1 3 1 0 3 1 0 3 0 1 1 3 0 2 14 38 38 38 14 2 1 3 3 3 1 2 0
0 1 0 3 2 0 3 3 12 36 36 36 12 0 3 3 3 1 2 2 2 0 3 2 0 2 1 56 3 0 2 0 3 1 0 0 3 3 0 3 2 0 14 38 38 38 14 3 2 3 0 1 3 0 1
2 1 3 0 1 2 3 2 3 2 2 1 3 1 0 0 0 1 3 3 3 3 2 1 2 1 0 1 0 1 3 1 2 3 1 2 1 1 2 2 1 2 2 3 1 2 3 2 2 1 1 2 2 1 2
0 2 0 1 1 0 0 0 0 1 2 0 0 3 2 1 1 2 0 3 2 2 1 2 1 2 0 1 2 3 3 2 2 0 0 3 0 3 2 0 3 3 2 2 3 2 0 3 0 1 1 1 3 1 1
1 0 3 1 1 3 1 0 2 0 3 1 1 2 0 0 2 1 2 0 0 3 2 3 2 0 0 1 3 0 3 0 3 1 1 0 2 3 3 3 1 1 2 0 1 1 2 3 0 0 0 1 3 1 2