12 12 12 12 16 12 12 12 12 12 12 12 12 12 16 12 12 12 12 12 12 12 12 12 16 12 12 12 12
12 0 0 0 16 0 0 0 0 0 0 0 0 0 16 0 0 0 0 0 0 0 0 0 16 0 0 0 12
12 0 0 0 16 0 0 0 0 0 0 0 0 0 16 0 0 0 0 0 0 0 0 0 16 0 0 0 12
12 0 0 0 16 37 13 37 13 0 0 0 13 37 16 37 13 0 0 0 13 37 13 37 16 0 0 0 12
16 16 16 16 16 16 16 16 16 0 0 0 16 16 16 16 16 0 0 0 16 16 16 16 16 16 16 16 16
12 0 0 38 16 72 72 72 80 0 0 0 0 0 0 0 0 0 0 0 83 72 72 72 16 36 0 0 12
12 0 0 14 16 72 72 80 0 0 0 0 0 0 0 0 0 0 0 0 0 83 72 72 16 12 0 0 12
12 0 0 38 16 72 80 0 0 0 0 0 0 0 0 0 0 0 0 0 0 0 83 72 16 36 0 0 12
12 0 0 14 16 80 0 0 0 0 0 0 0 0 0 0 0 0 0 0 0 0 0 83 16 12 0 0 12
12 0 0 0 0 0 0 0 0 0 0 0 0 0 0 0 0 0 0 0 0 0 0 0 0 0 0 0 12
12 0 0 0 0 0 0 0 0 0 0 0 0 0 0 0 0 0 0 0 0 0 0 0 0 0 0 0 12
12 0 0 0 0 0 0 0 0 0 0 0 0 0 0 0 0 0 0 0 0 0 0 0 0 0 0 0 12
12 0 0 14 16 0 0 0 0 0 0 0 32 31 31 31 35 0 0 0 0 0 0 0 16 12 0 0 12
12 0 0 38 16 0 0 0 0 0 0 0 28 24 29 24 30 0 0 0 0 0 0 0 16 36 0 0 12
16 16 16 16 16 0 0 0 0 0 0 0 28 30 56 28 30 0 0 0 0 0 0 0 16 16 16 16 16
12 0 0 38 16 0 0 0 0 0 0 0 28 24 31 24 30 0 0 0 0 0 0 0 16 36 0 0 12
12 0 0 14 16 0 0 0 0 0 0 0 33 29 29 29 34 0 0 0 0 0 0 0 16 12 0 0 12
12 0 0 0 0 0 0 0 0 0 0 0 0 0 0 0 0 0 0 0 0 0 0 0 0 0 0 0 12
12 0 0 0 0 0 0 0 0 0 0 0 0 0 0 0 0 0 0 0 0 0 0 0 0 0 0 0 12
12 0 0 0 0 0 0 0 0 0 0 0 0 0 0 0 0 0 0 0 0 0 0 0 0 0 0 0 12
12 0 0 14 16 81 0 0 0 0 0 0 0 0 0 0 0 0 0 0 0 0 0 82 16 12 0 0 12
12 0 0 38 16 72 81 0 0 0 0 0 0 0 0 0 0 0 0 0 0 0 82 72 16 36 0 0 12
12 0 0 14 16 72 72 81 0 0 0 0 0 0 0 0 0 0 0 0 0 82 72 72 16 12 0 0 12
12 0 0 38 16 72 72 72 81 0 0 0 0 0 0 0 0 0 0 0 82 72 72 72 16 36 0 0 12
16 16 16 16 16 16 16 16 16 0 0 0 16 16 16 16 16 0 0 0 16 16 16 16 16 16 16 16 16
12 0 0 0 16 39 15 39 15 0 0 0 15 39 16 39 15 0 0 0 15 39 15 39 16 0 0 0 12
12 0 0 0 16 0 0 0 0 0 0 0 0 0 16 0 0 0 0 0 0 0 0 0 16 0 0 0 12
12 0 0 0 16 0 0 0 0 0 0 0 0 0 16 0 0 0 0 0 0 0 0 0 16 0 0 0 12
12 12 12 12 16 12 12 12 12 12 12 12 12 12 16 12 12 12 12 12 12 12 12 12 16 12 12 12 12