16 16 16 16 16 16 16 16 16 16 16 16 16 16 16 16 16 16 16 16 16 16 16 16 16 16 16 16 16 16
16 0 4 4 0 0 0 0 0 0 0 0 0 38 56 36 0 0 0 0 0 0 0 0 0 0 0 0 0 16
16 0 4 0 0 4 0 0 0 4 0 0 0 14 56 12 0 0 0 0 0 4 4 4 0 0 0 0 0 16
16 4 0 0 0 4 4 4 4 0 4 4 0 38 56 36 4 4 4 0 0 0 0 4 0 0 0 0 0 16
16 0 0 0 0 0 4 0 0 0 0 0 4 38 56 36 0 0 4 4 0 4 4 4 0 0 0 0 0 16
16 4 0 0 0 0 0 0 0 0 0 0 0 14 56 12 0 0 0 0 4 4 0 0 0 0 0 0 0 16
16 0 0 56 37 13 37 56 4 4 0 4 0 38 56 36 4 0 4 0 4 0 0 0 0 0 0 0 0 16
16 0 0 56 56 56 56 16 16 16 0 0 16 16 16 16 16 16 0 0 16 16 16 0 0 0 56 0 0 16
16 0 0 56 39 15 39 16 0 0 0 0 0 0 0 0 0 0 0 0 0 0 16 37 13 37 56 0 0 16
16 0 0 56 0 0 0 16 0 0 0 0 0 0 0 0 0 0 0 0 0 0 16 56 56 56 56 0 0 16
16 0 0 0 4 0 4 0 0 0 0 0 0 0 0 0 0 0 0 0 0 0 0 0 4 4 4 0 0 16
16 0 0 4 0 0 4 0 0 0 0 68 67 67 67 67 67 67 71 0 0 0 0 0 0 0 0 0 0 16
16 0 0 0 0 0 0 16 0 0 0 64 84 84 84 84 84 84 66 0 0 0 16 56 0 0 0 0 0 16
16 0 4 0 0 0 0 16 0 0 0 64 84 84 84 84 84 84 66 0 0 0 16 36 0 0 0 0 0 16
16 0 4 0 0 0 4 16 0 0 0 64 84 84 84 84 84 84 66 0 0 0 16 12 0 4 0 0 0 16
16 0 4 0 0 4 0 16 0 0 0 64 84 84 84 84 84 84 66 0 0 0 16 12 4 4 0 0 0 16
16 0 0 4 0 0 0 16 0 0 0 64 84 84 84 84 84 84 66 0 0 0 16 36 4 0 0 0 0 16
16 0 4 0 0 0 0 16 0 0 0 64 84 84 84 84 84 84 66 0 0 0 16 56 0 4 4 0 0 16
16 0 4 0 0 0 0 0 0 0 0 69 65 65 65 65 65 65 70 0 0 0 0 0 0 0 0 4 0 16
16 0 4 4 0 0 0 0 0 0 0 0 0 0 0 0 0 0 0 0 0 0 0 0 0 0 4 4 0 16
16 0 4 0 0 0 0 16 0 0 0 0 0 0 0 0 0 0 0 0 0 0 16 0 0 0 56 4 0 16
16 37 13 37 37 13 37 16 4 0 0 0 0 0 0 0 0 0 0 0 0 0 16 0 0 0 56 4 0 16
16 56 56 56 56 56 56 16 16 16 0 4 16 16 16 16 16 16 0 0 16 16 16 0 0 0 56 4 0 16
16 0 0 4 0 0 0 4 38 56 0 0 0 0 0 4 0 4 0 4 56 36 0 4 0 0 56 0 0 16
16 0 0 4 0 0 0 4 14 56 37 13 0 4 0 0 4 0 13 37 56 4 4 4 0 0 56 0 0 16
16 0 0 0 0 0 0 0 38 56 56 56 0 4 0 0 4 4 56 56 56 37 13 37 13 37 56 0 0 16
16 0 0 0 0 0 0 0 0 0 0 0 4 4 4 4 0 4 0 0 56 56 56 56 56 56 56 0 0 16
16 0 4 0 0 0 0 0 0 4 0 0 0 4 0 4 0 4 0 0 0 0 0 0 0 0 0 0 0 16
16 0 4 4 0 4 0 0 37 56 0 0 0 0 0 0 4 0 0 0 0 0 0 0 0 0 0 0 0 16
16 16 16 16 16 16 16 16 16 16 16 16 16 16 16 16 16 16 16 16 16 16 16 16 16 16 16 16 16 16