12 12 39 39 12 12 39 39 12 12 0 2 3 0 0 2 1 0 3 1 15 15 39 39 15 15 39 39 15 15
12 0 3 3 0 0 2 0 2 12 2 3 3 0 56 3 2 2 0 3 15 2 0 2 0 0 3 2 3 15
36 3 16 16 3 3 16 16 2 12 3 2 1 0 56 0 2 0 2 3 15 3 56 56 2 2 56 56 2 38
36 0 16 2 3 3 2 16 1 12 2 1 1 1 56 1 3 3 3 1 15 1 56 3 2 2 1 56 2 38
12 1 3 3 60 3 2 2 2 12 2 2 3 1 56 1 0 3 0 1 15 1 2 1 2 63 2 2 3 15
12 1 3 3 3 3 2 2 2 12 2 2 0 0 56 0 3 3 1 1 15 1 2 1 2 2 2 2 3 15
36 3 16 0 2 2 0 16 2 12 0 3 0 0 56 3 0 1 1 1 15 3 56 3 1 1 1 56 1 38
36 1 16 16 3 3 16 16 3 12 2 1 0 2 56 1 2 0 2 2 15 3 56 56 1 1 56 56 3 38
12 3 0 2 2 2 0 0 2 12 0 1 2 3 3 3 1 0 2 1 15 1 2 1 1 1 0 1 1 15
12 12 12 12 12 12 12 12 12 12 0 2 1 2 3 3 2 2 3 2 15 15 15 15 15 15 15 15 15 15
0 2 0 0 0 0 1 1 3 1 3 3 0 0 0 0 2 3 1 3 1 0 2 2 3 2 1 1 1 2
3 3 2 3 2 3 1 1 1 0 2 1 0 3 0 3 3 0 0 3 0 3 3 1 1 1 0 2 0 3
0 2 0 1 1 3 3 0 0 3 1 0 2 0 3 3 2 1 2 1 1 3 2 1 2 1 1 3 1 2
1 1 2 3 3 1 1 0 3 3 3 2 1 68 67 67 71 3 1 2 2 2 2 3 3 2 1 1 2 2
2 0 0 2 0 2 1 2 1 0 0 3 1 64 16 56 66 3 0 2 3 1 16 16 16 16 16 16 16 3
1 16 16 16 16 16 16 16 0 3 0 3 2 64 56 16 66 3 1 1 3 3 3 3 3 0 1 2 1 1
0 1 3 2 1 1 2 2 0 1 0 3 1 69 65 65 70 2 0 0 0 2 1 2 1 3 1 0 2 0
1 1 2 3 2 2 2 0 3 0 0 0 0 1 3 1 3 3 0 1 0 0 0 2 2 1 1 1 2 3
1 0 3 2 3 1 3 3 2 3 1 3 1 0 1 2 1 0 2 2 2 1 1 2 1 3 0 3 1 0
0 3 2 1 0 1 1 3 2 1 1 1 0 1 0 1 1 0 3 2 1 3 1 3 3 1 0 3 2 2
13 13 13 13 13 13 13 13 13 13 1 1 2 2 2 1 3 2 1 0 14 14 14 14 14 14 14 14 14 14
13 3 3 2 3 3 3 0 3 13 0 2 1 0 3 2 0 3 1 3 14 0 2 2 0 0 0 2 1 14
36 1 56 56 3 3 56 56 1 13 1 1 3 3 3 56 0 0 1 0 14 1 16 16 1 1 16 16 3 38
36 3 56 3 3 3 1 56 1 13 2 3 2 2 2 56 1 0 3 1 14 0 16 2 0 0 2 16 1 38
13 1 0 0 0 0 3 0 3 13 1 0 2 1 2 56 2 3 2 3 14 0 0 0 1 1 1 1 3 14
13 1 0 0 61 0 3 0 3 13 2 0 3 0 3 56 3 2 1 1 14 0 0 0 1 62 1 1 3 14
36 0 56 3 0 0 1 56 3 13 3 0 0 3 3 56 0 1 0 2 14 3 16 0 1 1 0 16 2 38
36 0 56 56 0 0 56 56 1 13 2 3 1 0 2 56 2 1 3 3 14 0 16 16 1 1 16 16 1 38
13 1 0 1 2 2 0 2 0 13 1 1 3 0 3 56 3 0 1 2 14 0 2 0 2 2 1 1 2 14
13 13 37 37 13 13 37 37 13 13 1 3 2 0 3 2 1 3 0 1 14 14 37 37 14 14 37 37 14 14