14 14 14 14 14 14 14 14 14 14 14 14 86 86 84 86 14 14 14 14 14 14 14 14 14 14 14 14 14 14 14 14 14 14 14
14 4 0 4 4 0 0 4 0 0 0 0 64 84 86 66 0 0 0 0 0 0 0 0 4 4 0 4 4 4 4 0 4 4 14
14 4 4 4 0 4 0 0 4 0 4 0 64 86 84 66 0 0 0 0 0 0 0 0 4 4 0 0 0 0 0 0 4 4 14
14 0 0 4 0 56 56 56 0 0 0 4 64 84 86 66 0 0 0 4 0 4 0 0 4 4 0 0 0 0 0 4 0 0 14
14 4 4 0 0 38 56 36 0 4 0 0 64 86 86 66 0 0 4 0 0 4 0 0 0 0 4 0 4 4 4 4 0 0 14
14 0 0 0 0 38 56 36 0 0 0 0 64 86 84 66 0 0 4 0 0 0 0 0 0 0 0 0 0 0 0 0 0 0 14
14 4 4 0 0 38 56 36 0 0 0 0 64 84 84 66 0 0 4 0 0 0 0 0 0 4 4 0 0 4 4 0 4 0 14
14 0 0 0 0 56 56 56 0 0 0 0 64 86 86 66 4 0 0 0 4 4 0 56 56 56 0 0 0 4 0 0 0 0 14
14 0 0 0 0 4 4 0 4 4 0 0 64 84 84 84 67 71 0 0 0 0 4 38 56 36 0 4 0 0 4 4 0 0 14
14 0 0 0 4 0 4 0 0 0 0 0 69 65 84 84 84 66 4 0 0 0 0 38 56 36 0 0 0 4 4 0 0 0 14
14 0 0 0 0 4 0 0 0 4 0 0 0 0 64 84 86 66 0 4 0 0 0 38 56 36 0 4 0 0 4 0 0 0 14
14 0 0 0 0 0 0 0 0 0 0 0 4 0 64 86 86 66 4 0 4 0 0 56 56 56 0 4 0 0 4 0 0 0 14
14 0 0 0 0 0 0 0 0 0 0 4 0 0 64 84 86 66 0 0 0 0 0 0 0 0 0 0 0 0 0 0 0 0 14
14 4 4 0 4 0 0 4 4 4 4 0 0 68 84 86 84 70 0 0 0 0 0 0 0 0 0 4 4 0 0 0 0 0 14
14 0 0 4 0 4 0 4 0 4 4 4 16 64 84 86 66 16 4 4 4 4 4 4 0 0 0 0 0 0 0 0 0 4 14
14 4 4 0 0 4 0 0 4 0 4 4 41 41 41 41 41 41 4 4 4 4 4 4 4 0 0 0 0 4 0 0 0 0 14
14 0 0 56 37 37 37 56 4 4 0 0 41 41 41 41 41 41 4 4 0 0 0 4 4 0 4 0 0 0 0 4 0 0 14
14 0 4 56 56 56 56 56 4 0 0 0 16 64 86 86 66 16 4 0 0 0 0 0 4 0 0 0 0 0 0 4 0 0 14
14 0 0 56 39 39 39 56 4 0 0 68 67 84 86 86 66 0 0 0 4 0 0 0 4 0 0 0 0 0 0 0 0 0 14
14 0 4 0 0 0 4 0 0 0 0 64 86 84 65 65 70 4 0 0 0 0 0 0 4 4 0 0 0 0 4 0 0 0 14
14 0 0 0 0 0 0 0 0 4 0 64 86 66 0 4 0 0 0 0 0 0 0 4 4 4 4 0 0 0 0 4 0 0 14
14 0 0 0 0 0 0 0 0 4 0 69 65 84 71 4 4 0 0 4 4 0 0 4 4 0 56 37 37 37 56 0 0 0 14
14 0 0 0 0 0 0 0 0 0 0 0 0 64 84 67 71 0 0 0 4 0 4 4 4 0 56 56 56 56 56 0 0 4 14
14 0 0 0 4 4 0 0 4 0 0 0 68 84 65 84 84 71 4 0 4 4 4 4 0 0 56 39 39 39 56 0 0 4 14
14 0 0 0 0 4 4 0 4 68 67 67 84 70 0 64 86 66 4 4 4 4 0 4 0 0 0 0 0 0 0 0 0 4 14
14 0 0 0 0 0 4 0 68 84 84 84 70 4 0 64 86 66 0 0 0 0 0 4 0 0 0 0 0 0 0 4 0 0 14
14 0 0 0 4 0 4 0 64 84 84 70 4 0 0 64 86 66 0 0 0 0 0 0 0 0 4 0 0 0 4 0 0 0 14
14 0 0 4 0 0 0 4 64 84 70 0 0 0 4 69 84 66 0 0 0 0 0 0 4 0 0 0 0 4 0 4 0 4 14
14 0 0 0 4 0 0 41 41 41 41 0 4 0 0 0 69 84 71 0 4 4 40 0 0 0 0 0 0 0 0 0 0 0 14
14 0 0 0 0 0 4 68 84 66 0 0 0 0 0 0 0 64 84 67 67 67 40 67 67 71 0 0 0 0 0 0 0 0 14
14 4 4 0 4 0 4 64 84 70 0 0 4 4 0 0 0 64 66 0 0 0 40 0 69 84 71 0 0 4 0 0 0 0 14
14 0 0 4 68 67 67 84 70 0 4 0 4 4 0 0 0 64 84 71 0 0 0 0 0 64 66 0 0 4 4 0 0 0 14
14 0 0 0 64 84 84 70 4 0 0 0 0 4 0 0 16 64 86 66 0 56 56 56 0 64 66 0 0 0 0 4 0 0 14
14 0 40 68 84 86 66 0 4 4 0 4 0 4 4 0 41 41 41 41 41 38 56 36 4 64 66 0 0 4 0 4 0 0 14
67 67 40 84 86 84 66 0 4 4 4 0 0 0 0 0 41 41 41 41 41 38 56 36 0 64 66 0 0 4 0 0 4 0 14
84 65 40 65 65 65 70 4 56 56 56 4 0 0 0 0 16 64 86 70 0 38 56 36 0 64 66 4 4 0 4 0 0 4 14
66 0 40 0 4 0 0 0 38 56 36 0 0 0 0 0 68 84 66 4 0 56 56 56 0 64 66 4 0 4 0 0 0 0 14
66 0 0 0 4 0 0 4 38 56 36 0 0 0 0 68 84 65 84 71 0 0 0 0 0 64 66 0 0 0 0 0 4 0 14
84 66 0 0 0 0 0 0 38 56 36 0 4 0 68 84 70 0 69 84 71 0 0 0 0 69 84 71 0 0 0 0 0 0 14
84 66 0 0 0 0 0 0 56 56 56 0 0 68 84 70 0 0 0 69 66 0 0 0 0 0 69 84 71 0 0 0 0 0 14
84 66 0 0 0 0 0 0 0 0 0 0 68 84 66 0 0 0 0 0 64 71 0 0 0 0 0 69 65 71 0 0 0 0 14
84 66 0 0 0 0 0 0 0 0 0 0 64 84 66 0 0 0 0 0 64 66 0 0 0 0 0 0 0 64 71 0 0 0 14
84 84 67 67 67 67 67 67 67 67 67 67 84 84 84 67 67 67 67 67 84 84 67 67 67 67 67 67 67 84 84 67 67 67 67
84 85 85 85 84 85 85 84 84 86 86 86 86 84 84 84 86 84 86 84 84 84 85 84 85 85 85 85 85 85 85 85 85 84 84
84 84 85 85 85 85 85 84 86 86 84 84 86 84 84 84 86 84 84 84 84 84 85 85 84 85 85 85 84 84 84 84 84 85 84
84 84 84 84 84 84 84 84 84 84 84 84 84 85 84 84 85 84 84 84 84 84 84 84 84 84 84 84 84 84 85 84 84 84 84
84 84 85 85 85 84 85 85 84 84 84 84 85 85 85 85 85 85 85 84 84 84 85 84 85 84 85 85 84 85 84 85 85 84 84
84 84 84 84 84 84 84 85 85 85 84 84 85 84 84 84 84 85 84 84 84 84 85 84 84 84 84 84 84 85 85 84 85 84 84
84 84 85 84 84 85 85 85 84 84 84 85 84 84 84 84 84 85 84 84 84 84 85 85 85 85 84 84 84 85 85 84 84 85 84
84 84 84 84 84 84 84 84 84 84 84 84 84 85 84 84 84 84 84 84 84 84 84 84 84 84 84 84 84 84 84 84 84 84 84