73 72 75 74 72 75 72 72 74 74 75 72 74 73 72 75 73 74 73 74 72 74 73 72 73 75 72 73 74 75 73 74 73 75 74 73 74 72 74 72 72 73 75 75 73 74 74 73 75 74 72 74 72 74 73 72 72 72 72 75
72 72 75 73 75 74 74 73 75 72 74 72 74 74 73 74 72 75 73 72 75 73 74 74 74 75 72 75 74 74 72 72 75 74 72 72 74 73 72 75 73 72 72 75 73 74 72 74 72 75 72 74 76 75 73 75 75 74 74 75
75 72 75 75 72 72 75 75 73 72 75 73 72 75 72 72 73 74 72 75 72 72 74 74 75 75 74 74 75 75 74 72 73 72 75 73 73 75 74 72 72 73 75 72 74 76 75 72 75 75 72 73 73 74 75 74 75 75 75 75
74 75 76 75 74 72 72 73 75 73 75 75 73 72 73 73 72 72 72 74 74 73 73 73 75 73 72 73 72 72 74 72 72 73 75 72 74 75 75 73 73 75 75 72 72 74 75 72 73 75 74 73 75 73 72 75 73 73 74 72
75 72 72 72 75 75 74 72 72 72 74 73 74 74 74 75 72 74 72 72 72 73 75 74 75 75 72 74 72 72 72 74 73 72 73 73 74 73 74 72 74 75 75 74 75 73 73 73 73 73 73 74 73 75 74 73 75 73 73 72
75 73 73 74 72 72 75 76 75 75 73 72 75 72 74 75 76 72 72 75 75 75 74 74 74 73 72 75 72 72 74 75 74 73 75 74 74 73 72 73 75 73 75 73 72 76 74 73 73 72 75 72 74 73 76 73 75 74 75 75
72 75 72 74 74 73 72 75 72 74 75 73 74 72 73 74 74 75 73 72 73 73 74 73 75 76 73 73 75 72 75 73 72 75 73 74 74 72 73 72 72 75 75 72 73 75 74 75 74 75 74 75 74 72 74 73 72 75 73 75
74 73 75 72 73 72 74 74 75 74 73 74 74 73 74 72 75 72 72 72 74 75 72 73 73 74 72 75 73 72 75 73 72 73 73 74 75 72 73 73 73 75 72 74 73 75 73 73 73 74 72 73 72 75 74 72 72 72 74 73
72 73 74 74 73 72 74 75 75 75 72 72 73 73 74 74 72 74 72 74 74 73 75 75 74 75 75 72 72 72 75 73 72 74 75 74 73 73 73 75 73 74 73 73 72 72 73 73 72 73 74 73 74 74 73 72 72 72 73 72
74 74 74 73 74 72 75 75 73 72 74 72 75 72 75 75 72 72 72 72 73 75 73 75 72 72 75 75 73 72 72 72 72 72 73 73 74 73 73 72 73 75 74 74 75 75 73 74 73 72 75 73 72 75 75 72 73 72 73 73
76 75 73 72 73 73 72 75 73 72 73 72 74 73 75 75 74 73 72 74 74 74 74 72 75 75 74 75 74 73 72 75 73 74 74 74 74 74 73 74 73 73 75 75 75 74 73 72 74 72 75 73 74 72 74 75 73 76 75 72
72 74 73 74 73 74 72 72 72 75 72 72 75 74 72 74 75 72 72 74 74 75 72 75 72 72 75 74 74 72 72 73 74 75 75 74 75 74 73 75 72 73 76 56 37 56 76 74 72 74 74 75 72 74 72 74 72 74 75 74
73 72 73 73 74 73 75 73 74 73 73 73 75 73 72 72 75 56 37 56 72 73 72 72 74 74 75 75 75 73 73 72 74 75 75 75 74 73 72 74 75 74 72 38 56 36 73 72 75 75 75 73 75 73 75 72 72 73 72 72
75 75 72 75 72 74 72 73 73 73 73 74 73 74 74 73 72 38 56 36 74 75 73 72 73 74 75 72 72 73 75 72 74 74 75 74 74 74 73 74 73 74 73 56 39 56 73 75 75 73 73 73 75 76 72 72 74 72 75 75
73 75 74 73 75 75 75 75 73 73 73 75 75 73 72 72 75 56 39 56 74 75 75 73 73 73 73 72 75 75 74 72 73 72 73 75 72 74 72 73 72 73 72 73 74 73 74 73 75 75 72 72 74 75 72 75 75 75 73 75
75 74 74 74 72 74 72 72 72 72 72 74 75 75 75 75 72 72 74 74 75 74 72 72 72 73 74 75 75 73 75 56 37 56 74 73 72 75 73 75 74 75 72 72 75 75 75 72 72 72 75 74 72 75 74 73 73 74 74 75
74 72 75 73 72 72 73 72 76 73 73 75 72 73 73 75 73 72 73 72 74 74 73 73 74 74 75 75 74 72 72 38 56 36 74 75 73 72 73 73 72 74 75 72 72 75 72 73 72 72 75 72 72 75 74 75 74 72 72 73
75 74 75 72 74 73 73 74 74 72 72 74 75 75 75 75 73 75 74 72 72 75 75 72 74 72 72 73 75 72 72 56 39 56 74 75 73 74 74 74 75 74 74 72 75 72 75 73 72 75 75 73 75 73 75 72 72 74 72 75
73 73 75 73 75 75 73 74 72 74 75 75 73 74 73 75 76 75 73 73 75 74 74 72 74 75 73 75 74 75 73 75 74 74 72 72 73 75 74 76 72 73 74 75 74 74 75 75 72 75 73 74 75 74 72 73 73 73 75 75
75 74 75 72 73 74 75 72 74 74 72 74 73 72 72 75 73 74 72 73 75 75 75 73 76 72 74 73 76 73 74 75 73 75 72 72 73 72 72 74 74 72 74 75 72 72 74 72 73 75 75 72 76 73 75 72 75 73 72 74
73 74 73 72 72 72 73 75 73 73 72 73 74 75 73 74 74 72 75 75 74 74 72 72 72 74 73 72 75 74 72 75 73 74 73 74 72 75 75 74 72 73 74 74 73 56 37 56 73 72 72 74 76 74 72 75 74 73 76 75
75 75 73 75 72 75 73 74 72 75 75 72 75 74 73 74 72 72 72 75 72 72 75 74 74 75 74 72 74 73 72 74 74 75 74 73 74 72 73 72 75 74 75 75 75 38 56 36 73 72 73 72 72 72 72 73 73 73 75 74
74 74 73 74 75 74 72 74 75 73 72 72 75 72 75 72 75 72 73 74 72 74 75 72 73 73 72 75 74 80 83 75 73 80 83 73 75 74 74 74 72 72 75 75 73 56 39 56 73 72 74 73 74 75 73 72 74 72 75 73
74 74 74 72 73 72 74 74 73 73 75 74 75 72 74 74 72 72 74 75 72 75 74 72 75 75 73 75 80 0 1 83 80 3 1 83 73 75 73 72 75 75 75 75 72 73 74 75 73 75 74 73 75 72 75 75 74 74 75 75
74 75 74 74 72 72 74 75 75 73 73 75 72 73 75 73 73 75 74 75 75 75 73 72 76 76 74 80 2 2 1 0 0 0 3 2 83 72 74 73 75 75 76 74 75 74 73 74 73 75 73 75 73 73 72 72 72 73 74 72
75 75 72 74 75 75 75 73 72 75 73 73 73 76 73 74 75 75 72 74 72 75 75 76 75 73 80 1 0 0 2 1 2 1 3 0 0 83 75 75 73 73 72 75 73 73 73 75 75 74 73 74 72 72 75 75 75 72 75 73
72 76 76 72 73 74 73 75 75 72 72 74 73 74 73 74 72 75 74 72 75 74 72 74 75 80 2 2 3 2 2 2 2 2 0 2 1 82 74 73 74 72 74 72 72 75 74 72 74 73 73 72 73 75 72 72 72 75 73 74
74 72 72 74 74 74 75 72 72 73 72 73 75 72 75 73 73 75 73 73 72 74 72 74 80 3 0 68 67 67 67 67 71 1 3 2 82 73 72 72 73 74 75 72 74 74 74 72 73 73 73 72 72 73 73 75 72 72 72 73
72 75 73 75 75 75 75 73 75 73 74 75 73 73 73 73 73 74 75 73 73 75 75 80 1 3 0 64 84 84 84 84 66 1 2 82 72 73 73 73 74 72 73 73 72 75 74 74 73 75 73 72 73 75 74 72 75 72 75 73
75 73 72 74 74 75 74 73 74 73 72 74 72 73 72 73 73 72 74 74 80 83 80 0 2 0 3 64 84 84 84 84 66 0 1 83 80 83 75 72 75 73 73 74 74 74 74 72 72 72 73 72 73 72 73 72 74 74 75 73
72 75 72 74 73 75 74 72 74 73 75 73 74 73 72 73 75 74 72 80 1 2 2 3 0 0 0 64 84 84 84 84 66 0 0 3 0 0 83 74 74 74 73 72 72 75 73 72 74 72 74 72 72 74 74 72 73 72 73 75
72 72 73 74 73 73 56 37 56 73 73 72 74 75 73 75 73 74 73 81 3 2 2 0 3 1 3 64 84 84 84 84 66 2 3 0 1 0 1 83 74 75 73 73 72 76 56 37 56 74 72 75 74 72 75 74 72 73 75 74
72 74 75 74 73 72 38 56 36 73 73 74 75 74 74 75 72 72 75 75 81 3 0 3 3 2 3 69 65 65 65 65 70 0 56 37 56 1 3 2 83 73 72 75 73 74 38 56 36 72 73 75 74 73 72 74 74 72 75 75
74 72 75 74 73 73 56 39 56 72 73 72 75 73 73 75 72 72 75 74 75 81 2 0 3 0 1 3 2 2 0 2 0 0 38 56 36 3 1 0 82 75 72 75 74 72 56 39 56 72 75 72 75 74 74 74 74 72 74 75
72 72 75 75 74 73 73 73 74 72 72 72 72 74 56 37 56 72 72 72 74 74 81 0 3 2 3 3 1 1 1 3 3 3 56 39 56 1 1 82 74 74 73 72 73 73 72 75 72 73 73 73 72 75 73 75 76 75 75 72
73 74 72 74 75 73 74 73 75 75 74 74 72 72 38 56 36 73 72 74 73 72 80 2 0 2 2 2 2 2 1 3 0 0 3 3 1 2 82 72 74 74 73 72 74 73 74 72 73 74 73 74 72 73 73 72 72 75 73 75
73 73 74 74 72 73 74 75 75 73 73 75 74 74 56 39 56 74 75 74 74 73 81 2 1 82 81 0 3 2 3 1 1 0 3 2 0 82 74 73 74 72 75 74 74 73 73 73 74 72 74 73 74 73 74 75 74 72 72 73
75 73 73 74 73 74 74 74 75 72 75 75 72 72 74 75 74 73 74 73 74 75 72 81 82 72 75 81 0 0 2 1 82 81 2 2 82 73 75 74 74 75 72 72 72 75 75 72 74 73 75 73 74 72 75 75 73 73 75 72
73 73 74 73 72 76 72 73 73 72 74 75 75 73 75 75 72 74 72 75 73 74 74 74 72 72 72 74 81 2 2 82 75 75 81 82 75 72 75 75 73 72 72 74 72 72 75 72 74 74 75 72 72 75 73 74 72 73 73 73
73 73 75 72 75 74 72 74 73 73 74 75 72 75 73 75 75 75 75 76 73 73 73 75 75 73 73 73 73 81 82 75 73 72 74 72 73 74 75 75 74 72 74 73 73 73 72 72 74 72 73 75 72 74 73 75 74 74 75 72
73 72 74 75 72 72 75 75 75 72 72 73 72 73 73 73 72 75 74 72 72 73 75 73 73 73 74 74 73 75 75 72 73 74 74 73 72 74 73 72 75 75 75 73 76 72 72 72 74 73 72 74 75 74 75 75 74 72 73 74
72 72 72 74 72 75 74 74 75 72 74 74 73 73 72 72 72 74 72 72 73 73 75 74 72 75 74 73 73 73 75 75 72 75 75 73 72 73 75 74 73 73 72 73 74 72 73 74 72 74 75 72 72 73 75 73 75 74 74 75
73 72 75 75 74 72 73 74 74 75 72 73 74 75 72 73 73 72 74 74 75 73 75 74 73 72 56 37 56 74 75 73 73 73 73 75 74 74 72 72 73 75 74 73 75 74 73 56 37 56 72 72 75 73 75 73 74 74 74 74
75 75 72 75 75 75 72 75 75 73 74 73 72 72 75 75 75 74 75 75 75 72 75 72 75 75 38 56 36 75 74 75 73 75 75 75 73 74 74 74 72 74 72 74 73 72 75 38 56 36 74 74 75 75 72 74 72 75 74 75
73 74 74 75 72 72 75 75 75 72 74 72 75 75 74 75 72 72 72 74 75 72 76 72 72 73 56 39 56 74 74 74 73 74 76 73 72 72 73 74 72 72 72 73 75 75 75 56 39 56 74 72 72 73 72 74 74 76 75 74
75 72 73 74 73 75 74 72 73 72 72 75 74 72 75 73 74 74 72 74 74 74 72 74 72 72 74 74 75 72 75 75 75 72 75 72 74 74 75 72 75 74 75 74 73 74 75 73 74 72 72 75 73 72 75 73 72 72 73 72
74 74 75 75 75 73 75 75 73 72 74 56 37 56 75 74 74 74 73 72 74 72 75 74 73 72 74 74 75 75 75 75 72 72 73 72 75 74 74 75 75 74 72 73 73 74 74 75 72 74 76 72 74 75 73 74 74 72 75 75
73 72 72 74 74 74 72 72 75 73 75 38 56 36 74 73 73 72 75 75 75 75 73 73 75 74 73 74 74 72 73 73 72 75 75 74 74 75 72 73 74 75 75 72 72 72 75 74 72 75 74 72 72 73 72 73 73 73 72 72
73 73 73 76 72 75 72 75 75 74 75 56 39 56 73 74 74 75 73 73 75 73 75 72 73 73 75 74 74 75 74 73 73 73 74 75 74 72 73 75 74 75 74 74 72 72 75 72 73 74 75 73 72 75 72 74 73 73 75 72
74 72 72 74 75 72 73 73 73 72 75 72 74 76 75 74 75 75 73 73 75 75 74 72 72 72 72 74 72 75 72 75 74 75 74 75 74 72 74 72 73 74 75 73 73 74 75 72 74 72 75 72 73 73 73 73 75 75 73 75
72 74 74 75 75 72 74 73 72 75 75 73 75 73 74 73 73 73 74 73 73 75 72 74 73 75 72 74 75 72 74 74 72 73 72 72 75 75 74 73 72 75 72 73 74 74 75 75 72 72 72 74 73 75 72 73 73 73 75 75
74 73 73 73 74 73 75 72 72 73 74 72 74 72 75 74 72 74 75 73 72 75 74 75 72 72 73 73 72 74 73 75 74 72 74 75 74 75 75 75 73 72 72 75 75 75 73 74 74 75 75 72 72 74 75 72 75 75 72 74
73 73 72 72 73 73 72 74 75 75 73 73 72 72 75 75 73 74 75 75 73 74 73 75 73 74 72 73 72 76 76 75 73 75 72 75 72 72 73 75 73 75 73 72 73 72 73 72 73 74 72 75 76 75 75 72 74 75 74 75
73 73 72 73 72 75 73 73 72 72 72 72 73 72 73 72 75 72 74 75 72 72 73 73 73 72 74 75 73 76 73 75 75 75 72 73 72 72 72 72 72 75 74 75 72 74 73 73 74 75 73 75 73 74 75 72 72 73 73 74
74 74 72 73 75 73 73 73 74 72 75 73 73 74 74 74 73 73 73 75 73 72 74 72 76 76 76 76 76 76 79 76 76 76 76 73 74 72 73 75 73 75 72 74 75 74 72 73 72 72 75 74 73 75 74 72 76 73 73 72
74 75 73 75 73 75 73 74 72 73 75 72 73 75 74 72 74 75 74 72 75 72 75 73 73 76 76 76 76 76 76 76 76 76 72 73 75 72 72 73 72 72 72 74 72 74 72 75 72 74 75 73 73 75 74 72 74 73 75 74
75 72 73 76 75 72 73 73 73 72 75 75 76 75 73 74 75 75 73 74 74 75 73 74 73 73 75 75 76 76 76 73 72 72 73 72 72 74 73 72 75 75 72 75 73 73 73 75 72 75 75 74 74 73 72 73 75 75 72 74
72 72 72 74 72 73 75 75 73 72 74 72 73 74 74 74 75 72 74 73 72 73 75 72 72 74 73 75 73 76 74 73 75 75 75 72 74 75 75 74 73 72 75 74 75 73 74 74 72 72 72 75 73 73 73 75 73 74 72 73
72 74 74 73 74 74 74 75 73 74 73 72 73 72 74 75 72 74 73 72 72 73 74 72 72 73 72 74 76 76 76 74 75 73 72 73 74 72 72 75 74 75 74 72 74 75 75 75 74 72 74 72 72 72 73 74 73 72 73 72
74 73 75 74 72 75 72 75 73 72 74 72 74 74 73 75 75 74 75 75 72 72 75 75 72 75 75 75 72 72 74 74 74 73 73 73 73 72 75 75 74 75 75 73 73 74 74 73 72 75 75 74 75 75 73 72 75 75 72 72