66 0 0 40 39 39 39 15 15 15 15 15 15 15 39 39 39 40 0 0 64
66 0 0 40 0 0 0 0 0 0 0 0 0 0 0 0 0 40 0 0 64
66 0 0 40 0 0 16 0 0 0 60 0 0 0 16 0 0 40 0 0 64
66 0 0 40 0 0 16 0 0 0 0 0 0 0 16 0 0 40 0 0 64
66 0 0 40 0 0 0 0 16 16 16 16 16 0 0 0 0 40 0 0 64
66 0 0 40 0 0 0 0 0 0 16 0 0 0 0 0 0 40 0 0 64
66 0 0 40 0 0 0 0 0 0 16 0 0 0 0 0 0 40 0 0 64
66 0 0 40 0 0 0 0 0 0 16 0 0 0 0 0 0 40 0 0 64
66 0 0 40 0 0 0 0 0 0 16 0 0 0 0 0 0 40 0 0 64
66 0 0 40 0 0 0 0 0 0 16 0 0 0 0 0 0 40 0 0 64
66 0 0 40 0 0 0 0 0 0 16 0 0 0 0 0 0 40 0 0 64
66 0 0 40 0 0 0 0 0 0 16 0 0 0 0 0 0 40 0 0 64
66 0 0 40 0 0 0 0 0 0 16 0 0 0 0 0 0 40 0 0 64
66 0 0 40 0 0 0 0 0 0 16 0 0 0 0 0 0 40 0 0 64
66 0 0 40 0 0 0 0 0 0 16 0 0 0 0 0 0 40 0 0 64
66 0 0 40 0 0 0 0 0 0 16 0 0 0 0 0 0 40 0 0 64
66 0 0 40 56 56 0 56 0 0 16 0 0 56 0 56 56 40 0 0 64
66 0 0 40 56 56 0 56 0 0 16 0 0 56 0 56 56 40 0 0 64
66 0 0 40 0 0 0 0 0 0 16 0 0 0 0 0 0 40 0 0 64
66 0 0 40 0 0 0 0 0 0 16 0 0 0 0 0 0 40 0 0 64
66 0 0 40 0 0 0 0 0 0 16 0 0 0 0 0 0 40 0 0 64
66 0 0 40 0 0 0 0 0 0 16 0 0 0 0 0 0 40 0 0 64
66 0 0 40 0 0 0 0 0 0 16 0 0 0 0 0 0 40 0 0 64
66 0 0 40 0 0 0 0 0 0 16 0 0 0 0 0 0 40 0 0 64
66 0 0 40 0 0 0 0 0 0 16 0 0 0 0 0 0 40 0 0 64
66 0 0 40 0 0 0 0 0 0 16 0 0 0 0 0 0 40 0 0 64
66 0 0 40 0 0 0 0 0 0 16 0 0 0 0 0 0 40 0 0 64
66 0 0 40 0 0 0 0 0 0 16 0 0 0 0 0 0 40 0 0 64
66 0 0 40 0 0 0 0 0 0 16 0 0 0 0 0 0 40 0 0 64
66 0 0 40 0 0 0 0 16 16 16 16 16 0 0 0 0 40 0 0 64
66 0 0 40 0 0 16 0 0 0 0 0 0 0 16 0 0 40 0 0 64
66 0 0 40 0 0 16 0 0 0 60 0 0 0 16 0 0 40 0 0 64
66 0 0 40 0 0 0 0 0 0 0 0 0 0 0 0 0 40 0 0 64
66 0 0 40 37 37 37 13 13 13 13 13 13 13 37 37 37 40 0 0 64