72 72 74 76 75 75 72 76 75 73 73 74 74 74 72 72 73 74 72 75 73 73 73 75 74 72 73 74 75 74 73 73 74 73 73 73 74 74 74 72 75 74 74 74 73 75 74 72 73 75 74 75 74 73 73 73 74 72 76 73
72 72 73 74 75 73 75 72 75 74 73 72 74 74 73 74 75 73 73 73 75 73 72 75 73 72 74 74 72 72 75 74 74 73 74 75 73 73 74 72 75 72 74 76 72 75 74 74 75 73 75 75 72 74 72 72 75 75 75 75
75 73 73 75 73 73 75 75 74 75 72 74 76 75 72 75 74 74 74 75 72 73 75 72 72 74 72 72 72 75 72 72 72 76 72 76 72 74 73 72 74 72 72 73 74 74 75 74 73 72 72 74 75 74 75 73 72 75 74 75
73 73 74 75 72 73 74 73 73 75 74 74 73 75 74 74 75 75 75 73 73 73 72 76 72 74 74 74 74 73 74 74 73 72 73 73 75 74 72 73 75 73 76 72 74 73 75 76 75 72 72 73 76 75 72 73 74 76 72 75
72 73 73 74 72 73 73 74 73 72 74 75 75 73 76 72 73 75 74 74 74 74 72 75 73 74 73 75 76 75 75 75 74 75 73 75 72 72 72 73 75 75 72 75 73 73 74 72 73 73 73 74 75 73 75 72 74 73 74 75
75 76 72 75 74 74 75 75 75 72 76 74 72 72 72 73 75 74 73 73 72 76 73 72 75 74 74 75 74 73 75 73 75 73 75 74 73 73 74 75 74 74 73 75 75 75 75 76 74 72 74 74 75 73 74 72 72 72 73 74
73 72 73 75 75 73 74 75 74 73 73 75 74 73 74 75 72 75 73 72 73 75 72 75 75 72 72 74 74 73 73 75 73 74 73 74 74 76 72 74 74 72 74 76 75 74 73 74 72 74 72 72 75 73 72 72 72 72 75 72
72 73 72 74 72 74 76 73 73 75 72 73 72 72 75 75 75 75 75 73 75 75 73 74 75 76 74 72 73 75 73 74 74 76 73 75 74 72 75 75 74 75 75 75 75 74 75 73 73 72 73 72 74 74 74 73 76 72 75 73
72 74 74 75 73 75 72 74 74 72 74 74 72 75 74 75 73 76 74 74 73 74 72 75 73 75 72 74 72 74 73 75 75 72 75 73 72 73 74 72 73 72 74 74 72 73 75 72 75 72 73 74 75 74 74 74 73 73 72 73
75 73 73 72 75 75 73 73 75 75 73 75 75 75 74 73 75 75 75 75 73 73 74 73 73 73 74 72 75 74 75 73 72 72 75 75 73 74 74 75 73 72 73 72 73 73 73 73 75 72 75 72 74 75 73 75 75 73 74 72
74 74 75 73 75 73 75 75 73 74 72 73 75 75 74 72 73 72 73 72 74 73 73 74 74 73 75 75 72 75 73 72 73 76 74 74 72 72 75 73 75 75 74 74 73 72 72 74 74 73 73 75 74 75 72 75 75 72 75 73
74 75 74 73 75 74 74 72 76 75 75 73 72 72 73 16 16 16 73 72 72 74 75 75 72 75 74 75 72 73 75 74 75 74 73 74 74 75 72 75 75 56 56 56 75 73 72 73 75 75 74 72 72 75 72 75 72 74 73 74
72 76 74 72 74 74 75 73 76 75 74 72 73 74 80 16 39 16 16 75 72 72 74 73 73 74 73 75 75 73 73 72 76 72 74 73 73 75 73 72 56 56 39 56 83 72 72 73 74 74 74 73 76 75 74 74 75 73 72 72
74 74 75 75 75 73 74 73 74 73 75 73 75 80 1 2 2 39 16 16 72 72 74 73 72 72 73 72 74 73 72 72 73 74 72 73 72 74 74 56 56 39 1 3 0 83 72 73 75 73 73 75 74 73 75 73 75 73 75 75
72 73 72 73 72 72 73 72 72 72 72 72 80 3 1 1 3 2 38 16 72 72 75 73 72 75 73 73 75 72 73 72 75 75 75 75 72 74 73 56 36 2 0 1 1 0 83 75 73 74 72 73 74 74 73 76 74 73 73 73
73 73 73 75 72 73 74 75 73 72 74 16 16 2 1 3 2 1 38 16 73 73 75 75 75 75 74 73 76 74 75 72 72 75 74 73 73 74 74 56 36 3 1 2 2 1 56 56 75 74 74 75 73 75 75 73 74 75 73 72
75 76 75 75 74 74 72 72 75 74 74 16 36 3 2 1 1 2 16 16 75 74 72 74 73 74 73 75 74 73 73 74 74 74 73 73 75 73 80 56 56 3 3 1 2 3 38 56 75 73 73 72 75 75 72 73 73 74 74 74
74 74 74 72 76 74 73 72 75 75 75 16 16 36 2 0 1 0 2 83 80 83 80 83 75 74 75 73 73 73 74 72 75 72 75 80 83 80 2 2 2 2 1 1 2 38 56 56 74 74 73 72 72 73 75 72 72 73 73 73
73 75 72 75 75 72 73 72 72 73 73 73 16 16 37 37 16 0 3 1 2 3 3 82 74 75 73 74 73 73 74 72 74 75 80 1 2 3 1 3 1 3 56 37 37 56 56 74 73 73 72 73 75 74 74 75 72 74 72 74
73 74 72 75 72 75 73 72 75 74 75 75 74 16 16 16 16 1 1 62 2 68 71 83 72 73 75 76 72 75 74 72 72 74 81 1 68 71 2 61 2 82 56 56 56 56 74 75 75 73 74 75 75 72 72 75 73 72 74 73
75 73 72 76 72 72 74 74 74 74 75 72 72 73 74 75 81 3 3 2 68 86 66 1 83 74 74 74 72 72 73 73 75 75 80 2 64 85 71 2 2 83 72 72 74 73 73 72 74 72 72 72 72 73 74 73 73 74 72 72
73 74 73 73 75 73 75 73 74 75 75 72 73 74 74 74 73 81 3 68 86 86 70 2 82 72 75 73 75 73 74 72 75 74 81 1 69 85 85 71 1 82 74 73 74 74 73 73 74 72 75 74 75 76 73 75 73 72 73 74
73 74 73 74 74 75 74 75 73 73 72 75 73 74 73 73 75 80 2 69 65 70 0 82 75 72 73 72 74 75 75 73 74 73 74 81 1 69 65 70 2 83 72 72 75 75 72 72 73 74 75 72 74 72 74 75 73 76 74 74
73 75 72 73 73 73 74 72 75 72 73 73 73 73 73 73 74 81 3 2 3 0 82 72 72 74 74 75 75 74 72 72 72 73 73 75 81 3 0 82 81 82 75 73 74 73 74 72 72 74 74 74 75 75 74 73 74 73 74 73
72 73 72 73 73 74 75 74 72 72 74 72 75 73 73 74 73 73 81 82 81 82 75 72 74 73 72 74 73 72 74 72 72 75 75 73 73 81 82 73 72 73 73 72 74 75 75 73 72 72 75 74 74 73 72 75 73 72 75 72
75 73 74 74 72 75 73 73 73 75 74 73 75 75 72 75 73 72 73 74 72 72 75 73 74 75 72 75 75 75 72 72 74 75 74 73 72 72 72 73 72 74 74 74 72 74 72 73 74 74 75 72 72 75 73 73 74 75 74 72
75 74 75 74 75 74 72 73 73 72 75 73 73 72 73 72 73 72 72 74 72 73 74 75 73 74 74 72 73 72 72 74 75 75 75 72 74 74 73 72 73 75 72 75 75 73 75 76 74 74 74 73 74 73 74 75 75 72 74 72
72 75 74 76 75 73 73 74 75 73 73 75 75 74 76 72 74 75 72 75 74 75 73 72 73 74 74 72 73 75 75 73 73 73 75 73 72 75 73 73 73 75 73 74 72 74 75 75 72 74 72 75 74 74 74 74 75 73 73 72
75 73 72 73 72 74 73 72 74 72 73 73 74 75 75 74 75 72 72 75 75 75 74 75 73 75 72 74 72 73 74 75 74 75 74 72 75 75 74 73 74 75 72 73 74 75 73 73 75 74 73 74 75 73 72 75 72 72 74 73
73 72 75 74 74 72 75 76 72 73 72 72 72 72 74 72 74 72 74 72 72 72 74 72 75 72 73 73 74 76 76 73 72 72 75 73 75 72 75 74 73 73 75 73 74 74 72 72 74 75 72 73 75 72 75 75 73 73 72 75
72 74 72 74 75 75 72 75 73 73 75 72 75 73 74 72 75 75 73 75 72 73 74 73 74 72 75 74 73 76 76 74 74 74 74 72 75 73 74 72 74 73 74 72 74 76 75 73 75 75 72 74 73 72 73 73 75 76 75 75
75 75 73 75 72 73 73 73 72 72 73 74 74 75 72 74 72 76 74 72 72 75 73 74 75 74 73 73 72 75 73 73 74 75 75 74 73 73 72 72 73 75 72 75 75 73 73 74 73 73 75 72 74 75 74 74 74 74 74 73
73 75 72 76 73 72 72 76 73 73 72 73 73 73 74 75 72 75 73 74 72 72 72 72 72 74 72 72 75 73 72 72 74 73 73 72 74 72 72 74 72 72 75 75 72 73 74 74 74 73 72 74 73 73 75 72 75 73 72 73
72 75 73 72 73 73 74 75 74 73 75 73 75 73 74 75 73 75 72 74 72 75 75 72 75 72 74 74 75 75 72 73 75 73 72 72 73 72 75 73 72 74 74 73 73 72 72 75 73 73 73 76 75 72 73 74 72 72 72 72
75 72 76 75 74 74 74 73 73 73 74 74 75 75 73 72 75 72 72 74 74 73 72 74 73 74 72 73 75 74 72 74 72 72 74 74 73 75 75 73 75 73 72 75 75 74 75 73 73 73 74 74 72 73 73 73 73 72 73 72
74 75 74 72 74 76 74 75 74 72 74 75 74 72 73 72 72 72 72 72 80 83 75 72 73 75 73 72 75 73 74 75 74 74 74 72 73 74 80 83 80 83 73 75 75 75 74 73 72 73 74 74 72 72 74 72 73 75 72 75
72 73 72 74 75 75 72 75 74 73 72 75 74 74 74 75 75 80 83 80 3 2 83 74 73 75 72 73 72 75 74 72 75 74 73 73 73 80 3 2 2 1 83 72 72 73 75 73 72 72 74 72 73 73 74 74 75 75 73 75
74 73 75 73 73 73 72 73 73 75 73 72 73 75 72 72 75 81 2 68 67 71 2 83 73 73 73 72 73 73 75 74 73 73 73 72 80 1 68 67 71 3 82 73 73 74 72 72 72 74 74 74 75 72 74 73 73 74 75 72
75 74 76 74 72 72 73 74 74 72 72 74 72 73 74 75 75 80 3 69 87 87 71 3 83 72 72 75 74 75 75 73 75 74 75 80 3 68 84 84 70 0 83 73 72 74 73 74 73 75 74 72 73 72 74 74 74 75 73 74
74 73 74 74 74 73 75 73 75 73 74 75 72 72 75 72 74 81 3 0 69 87 66 1 82 72 74 75 73 74 73 75 72 73 74 81 3 64 84 70 2 1 2 83 75 73 75 75 74 72 72 74 72 72 76 75 74 72 72 73
73 75 73 75 73 72 74 74 74 74 72 74 75 56 56 56 56 80 0 63 1 69 70 3 83 74 74 72 75 74 76 75 72 75 72 73 81 69 70 0 60 3 2 16 16 16 16 72 72 72 74 75 75 75 74 73 74 74 73 72
73 72 72 74 72 73 74 73 72 72 72 72 56 56 39 39 56 0 0 3 1 1 2 3 82 74 73 72 72 72 75 75 74 75 75 75 80 2 3 3 3 0 0 16 39 39 16 16 72 75 73 74 72 73 74 73 75 74 72 73
76 72 75 75 73 74 73 73 75 73 72 56 56 36 0 2 3 0 0 1 2 82 81 82 74 73 72 72 73 75 75 75 75 74 72 72 81 82 81 82 81 0 1 2 1 3 38 16 16 72 72 74 74 72 74 73 74 73 74 75
72 72 72 73 76 75 73 73 73 73 73 56 36 2 2 2 1 3 56 56 82 74 73 73 75 75 75 74 72 72 72 73 75 75 73 73 73 74 74 72 16 16 1 2 0 2 1 38 16 72 74 72 74 75 75 73 74 76 72 74
72 75 72 73 72 75 75 75 74 72 74 56 56 2 0 2 0 3 38 56 74 72 74 73 75 75 74 75 73 72 74 76 74 74 72 73 74 72 72 72 16 36 1 3 1 3 2 16 16 72 74 74 74 74 72 72 74 73 73 74
74 73 76 75 72 72 75 73 74 75 73 73 81 1 3 0 0 1 38 56 74 73 75 72 72 74 72 74 75 74 75 73 72 74 74 72 72 75 72 72 16 36 2 3 2 2 0 82 75 75 72 72 74 74 73 75 73 72 73 74
75 75 72 72 74 72 74 74 74 73 74 73 74 81 1 1 3 37 56 56 74 72 75 72 73 74 74 74 72 74 73 75 72 73 72 74 72 75 73 75 16 16 37 3 0 0 82 75 75 73 73 74 72 74 73 75 72 75 74 74
74 75 72 72 75 74 74 74 74 72 73 75 75 75 81 56 37 56 56 75 73 72 72 73 72 72 75 74 72 74 72 75 72 72 72 74 73 75 74 72 73 16 16 37 16 82 75 72 74 72 72 73 75 75 74 74 73 74 75 75
74 75 75 73 73 73 74 73 74 74 74 73 73 75 73 56 56 56 74 72 73 74 73 75 74 73 73 74 73 75 74 73 74 75 74 74 74 73 74 74 72 75 16 16 16 75 74 74 73 73 72 72 72 74 76 73 74 72 75 72
74 73 75 74 73 73 75 72 75 74 73 72 73 72 74 72 74 74 75 74 75 75 74 76 74 75 73 72 73 72 72 72 74 75 74 72 73 73 74 72 72 72 74 72 73 73 72 73 74 74 74 72 72 73 72 75 75 75 73 72
72 76 72 75 73 72 72 73 74 73 72 72 74 72 73 75 74 75 74 72 73 73 73 72 75 74 75 75 75 73 74 72 75 72 73 73 75 75 74 75 74 73 74 75 73 73 72 74 74 72 75 75 75 73 72 75 74 72 73 74
74 73 72 72 75 72 72 73 74 74 74 72 73 75 74 73 73 75 72 75 73 72 72 72 74 73 73 76 74 72 72 73 74 74 72 74 72 74 76 72 72 74 72 75 72 72 72 73 72 74 73 75 73 75 74 74 72 72 75 75
72 75 75 74 74 75 75 73 75 72 75 75 72 73 74 75 73 74 73 74 75 75 74 75 72 73 74 73 73 74 73 75 72 75 72 75 74 73 75 74 73 75 73 73 75 75 75 75 76 72 72 73 74 75 73 74 72 75 74 73
72 72 75 75 73 74 73 73 73 72 72 76 72 75 72 72 72 72 76 72 74 73 75 75 74 73 74 72 74 73 73 73 75 75 73 73 75 74 74 73 75 74 72 74 72 73 74 72 75 76 75 73 74 72 75 74 74 75 72 75
75 72 73 73 72 72 75 73 72 72 75 75 75 75 73 72 72 75 75 73 73 75 73 75 73 74 73 74 73 72 74 74 74 75 76 73 75 74 73 74 73 75 75 75 74 72 73 75 72 75 72 75 75 72 75 75 74 73 72 75
74 72 72 72 75 74 76 72 75 74 73 72 72 75 74 72 73 74 73 72 74 73 74 72 72 74 75 74 75 74 72 75 75 72 73 72 72 74 72 73 72 74 73 75 73 73 73 73 73 72 74 75 74 73 76 72 74 72 72 74
73 74 74 74 73 72 72 72 72 75 74 72 75 72 73 72 74 73 74 75 75 73 74 75 76 74 73 75 74 74 76 72 75 74 73 75 75 73 75 72 73 73 72 74 74 72 75 74 72 73 72 74 73 75 75 74 74 74 74 74
75 73 75 76 72 74 75 75 74 74 75 74 72 72 74 76 73 72 75 75 75 74 73 74 75 73 76 72 75 74 73 74 74 75 73 75 76 75 74 75 75 73 76 73 74 75 73 73 72 73 74 74 75 74 72 74 72 75 76 73
72 72 75 72 73 74 72 74 76 73 73 73 74 73 74 73 72 74 72 76 73 72 73 74 73 73 72 75 75 73 73 75 73 74 73 72 75 75 73 75 75 72 74 72 75 74 74 72 76 75 73 72 75 73 72 75 76 75 75 75
72 72 74 75 75 75 73 73 75 75 72 74 72 74 73 75 72 73 74 75 73 74 74 76 75 76 74 72 72 76 72 74 73 76 74 72 72 72 75 74 73 73 75 74 75 75 74 74 75 74 73 74 75 73 74 75 75 75 72 72