36 15 15 15 15 15 39 15 15 15 15 15 39 15 15 15 15 15 39 15 15 15 15 15 39 16 39 15 15 15 15 15 39 15 15 15 15 15 39
12 32 35 0 0 0 0 0 4 0 4 0 0 0 0 4 0 0 0 4 0 0 20 20 15 16 15 0 0 0 0 0 0 0 0 0 0 0 14
12 33 34 0 0 0 0 0 0 0 0 0 16 0 0 0 0 0 0 0 0 0 20 20 15 15 15 0 0 0 0 0 0 0 0 0 0 0 14
12 0 0 0 4 0 0 0 0 4 0 0 16 0 4 0 0 0 0 0 0 4 0 0 0 0 0 0 0 0 0 0 0 0 0 0 0 0 14
12 0 0 0 0 0 0 0 4 0 0 0 16 0 0 0 0 0 0 4 0 0 0 0 15 12 12 0 0 0 0 0 0 0 0 0 0 0 14
12 0 4 0 0 4 0 0 0 0 0 0 16 0 0 0 4 0 0 0 4 0 4 0 14 16 12 0 0 0 0 32 31 35 0 0 0 0 14
36 4 0 0 4 0 16 0 0 0 0 0 16 0 0 0 0 0 16 0 0 0 0 0 38 16 36 0 0 0 0 28 24 30 0 0 0 0 38
12 0 0 0 0 0 0 0 0 0 0 0 0 4 0 4 0 0 0 0 0 4 0 0 14 16 12 0 0 0 0 28 24 30 0 0 0 0 14
12 4 0 4 0 0 4 0 0 4 0 0 0 0 0 0 4 0 0 0 0 4 0 0 14 14 13 0 0 0 0 28 24 30 0 0 0 0 14
12 0 0 0 0 0 4 0 4 0 0 32 31 35 0 0 0 0 0 4 0 0 4 0 0 0 0 0 0 0 0 28 24 30 0 0 0 0 14
12 0 0 4 0 0 0 0 0 0 32 24 24 24 35 0 0 4 0 0 0 0 0 0 15 12 12 0 0 0 0 28 24 30 0 0 0 0 14
12 0 0 0 4 0 0 0 0 32 24 24 29 24 24 35 0 0 4 0 4 4 0 0 14 16 12 0 0 0 0 28 24 30 0 0 0 0 14
36 0 16 16 16 16 16 0 0 28 24 30 16 28 24 30 0 0 16 16 16 16 16 0 38 16 36 0 0 0 0 28 24 30 0 0 0 0 38
12 0 0 0 4 0 0 4 0 33 24 24 31 24 24 34 0 0 4 0 0 0 0 0 14 16 12 0 0 0 0 28 24 30 0 0 0 0 14
12 0 0 0 0 0 0 0 0 0 33 24 24 24 34 0 0 4 0 0 0 0 4 0 14 14 13 0 0 0 0 28 24 30 0 0 0 0 14
12 0 0 4 0 0 0 4 0 0 0 33 29 34 0 4 0 0 0 0 0 0 0 0 0 0 0 0 0 0 0 28 24 30 0 0 0 0 14
12 0 0 0 0 0 0 0 0 0 0 0 0 0 0 0 0 4 0 0 0 0 0 0 15 12 12 0 0 0 0 28 24 30 0 0 0 0 14
12 0 4 0 0 0 0 0 0 0 4 0 0 4 0 0 0 0 0 0 0 4 0 0 14 16 12 0 0 0 0 28 24 30 0 0 0 0 14
36 0 0 0 0 0 16 0 0 0 0 0 16 0 0 0 0 0 16 0 0 0 0 0 38 16 36 0 0 0 0 28 24 30 0 0 0 0 38
12 0 4 0 0 0 0 0 0 0 0 0 16 0 4 0 0 0 0 0 0 4 0 0 14 16 12 0 0 0 0 33 29 34 0 0 0 0 14
12 0 0 0 0 4 0 0 0 0 0 0 16 0 0 0 4 0 0 0 0 0 0 0 14 14 13 0 0 0 0 0 0 0 0 0 0 0 14
12 0 0 0 0 0 0 0 0 0 4 0 16 0 0 0 0 0 4 4 0 0 0 0 0 0 0 0 0 0 0 0 0 0 0 0 0 0 14
12 20 20 0 4 0 0 4 0 0 0 0 16 0 4 4 0 4 0 0 0 0 20 20 13 13 13 0 0 0 0 0 0 0 0 0 0 0 14
12 20 20 0 0 0 0 0 0 0 4 0 0 0 0 4 0 0 0 0 0 0 20 20 13 16 13 0 0 0 0 0 0 0 0 0 0 0 14
37 13 13 13 13 13 37 13 13 13 13 13 37 13 13 13 13 13 37 13 13 13 13 13 37 16 37 13 13 13 13 13 37 14 14 14 14 14 38