39 12 12 12 39 12 12 12 39 12 12 40 39 40 12 12 39 12 12 12 39 12 12 12 39
15 0 0 4 0 0 0 0 0 0 4 40 0 40 0 0 0 4 0 4 0 0 0 0 15
41 41 41 41 41 41 41 41 41 41 41 40 41 41 41 41 41 41 41 41 41 41 41 41 41
12 0 0 16 16 4 0 0 0 0 4 40 0 40 0 4 0 0 0 4 16 16 0 0 14
41 41 41 41 41 41 41 41 41 41 41 41 41 40 41 41 41 41 41 41 41 41 41 41 41
12 0 0 0 0 0 16 16 16 16 16 40 0 40 16 16 16 16 16 0 4 0 4 0 14
12 0 0 0 0 0 0 0 0 0 16 40 0 40 16 0 0 0 0 0 0 0 0 0 14
12 0 0 0 0 0 0 0 0 4 16 40 0 40 16 0 0 0 0 0 0 4 0 0 14
36 0 0 0 0 0 0 0 4 0 16 40 4 40 16 0 0 0 0 0 0 4 0 0 38
12 0 0 0 4 0 0 0 0 0 0 40 0 40 0 0 0 0 0 4 0 0 4 0 14
12 0 0 0 0 0 0 0 0 0 0 40 16 40 0 0 0 0 0 0 0 0 0 0 14
12 0 0 0 0 0 0 4 0 4 0 40 16 40 0 4 0 0 0 0 4 4 0 0 14
12 0 0 0 0 0 0 0 0 4 0 40 0 40 0 0 0 0 0 4 0 0 0 0 14
36 0 0 0 4 0 0 0 0 0 16 40 0 40 16 0 0 0 0 0 0 0 0 0 38
12 0 0 0 0 0 0 0 0 0 16 40 0 40 16 0 0 0 4 0 0 0 4 0 14
12 0 0 4 0 0 0 0 0 4 16 40 0 40 16 0 0 4 0 4 0 4 0 0 14
12 0 0 0 0 0 16 16 16 16 16 40 0 40 16 16 16 16 16 0 0 0 0 0 14
41 41 41 41 41 41 41 41 41 41 41 40 41 41 41 41 41 41 41 41 41 41 41 41 41
36 4 0 16 16 4 4 4 0 4 4 40 0 40 0 0 0 4 0 0 16 16 0 0 38
41 41 41 41 41 41 41 41 41 41 41 41 41 40 41 41 41 41 41 41 41 41 41 41 41
12 0 0 0 0 4 0 0 0 0 0 40 0 40 0 0 4 0 0 0 0 0 0 0 13
12 0 0 4 0 0 0 0 0 0 4 40 4 40 0 0 0 0 4 4 0 0 4 0 13
12 0 0 0 4 0 0 4 0 0 0 40 0 40 4 4 0 4 0 0 0 4 0 0 13
12 0 0 0 0 0 0 0 0 0 4 40 0 40 0 4 0 0 0 0 0 0 0 0 13
37 13 13 13 37 13 13 13 37 13 13 40 37 40 13 13 37 13 13 13 37 13 13 13 37