15 15 39 15 15 39 15 15 39 15 15 39 15 15 39 15 15 15 39 15 15 39 15 15 39 15 15 39 13 14
14 14 14 14 14 14 14 14 14 14 14 14 14 14 14 14 14 14 14 14 14 14 14 14 14 14 14 14 13 14
36 15 52 48 52 48 48 48 48 48 40 48 48 48 48 48 48 52 52 48 48 40 48 48 48 48 48 48 13 38
12 15 52 48 52 48 48 48 48 48 40 52 48 52 48 48 48 48 48 48 48 40 48 48 48 48 48 48 13 14
12 15 48 48 48 52 52 48 48 48 40 48 48 48 48 48 48 48 48 48 48 40 48 48 48 48 48 48 13 14
36 15 48 48 48 52 48 48 52 48 40 48 48 48 52 52 48 48 48 48 48 40 48 48 48 48 48 48 13 38
12 15 56 56 56 56 56 56 56 48 40 41 41 41 41 41 41 41 41 41 41 40 48 52 52 48 52 48 13 14
12 15 48 48 48 48 48 52 48 48 40 48 48 48 48 52 48 48 48 48 48 40 48 48 48 48 48 52 13 14
36 15 48 48 48 48 48 48 48 48 40 48 48 48 52 52 48 48 48 48 56 56 56 48 48 48 48 48 13 38
12 15 48 48 52 48 48 48 48 48 40 48 48 52 48 48 48 48 48 48 56 56 56 48 48 48 48 48 13 14
12 15 48 48 48 48 48 48 48 48 40 48 48 48 48 48 48 48 48 48 56 56 56 52 48 48 48 48 13 14
36 15 52 48 48 48 48 48 48 48 40 48 52 48 48 48 48 48 48 48 48 48 48 52 48 48 48 48 13 38
12 15 52 48 48 48 48 48 52 48 40 52 48 48 48 48 48 48 48 48 48 48 48 48 48 48 48 48 13 14
12 15 52 48 48 48 48 48 48 48 40 52 52 48 52 48 48 48 48 48 48 48 48 48 48 48 48 48 13 14
36 15 48 48 48 48 48 48 48 48 40 41 41 41 41 41 41 41 41 41 41 41 41 41 41 41 41 41 13 38
12 15 48 48 48 48 48 48 48 48 40 56 56 56 56 56 56 56 56 56 56 40 48 48 52 48 48 48 13 14
12 15 48 48 48 48 48 48 52 48 40 56 48 48 48 48 48 48 48 48 56 40 48 48 48 48 48 48 13 14
12 15 48 52 52 48 48 48 48 52 40 48 48 48 48 48 48 48 48 52 48 40 48 48 48 48 48 48 13 14
36 15 52 52 48 48 48 48 48 48 40 56 52 52 52 48 48 48 48 48 56 40 48 48 48 48 48 48 13 38
12 15 48 52 48 48 48 48 48 48 40 56 56 56 56 56 56 56 56 56 56 40 48 48 52 48 48 48 13 14
12 15 48 52 48 48 48 48 48 52 40 41 41 41 41 41 41 41 41 41 41 40 52 48 48 52 48 48 13 14
36 15 48 52 48 48 48 48 48 48 40 48 48 48 48 48 52 52 48 48 48 40 52 48 48 48 48 48 13 38
12 15 48 48 48 52 52 48 52 48 40 48 48 48 48 48 48 48 48 48 48 40 52 52 48 48 48 48 13 14
12 15 48 48 48 48 52 52 52 48 40 48 48 48 48 48 48 48 48 52 48 40 52 52 48 52 48 48 13 14
36 15 48 52 48 48 48 48 48 48 40 48 48 48 48 48 48 48 48 52 48 40 48 48 48 52 48 48 13 38
12 15 41 41 41 41 41 41 41 41 40 48 52 52 48 52 48 48 48 52 48 40 48 48 48 52 48 48 13 14
12 15 48 52 48 48 48 48 48 52 40 48 48 48 48 48 48 48 48 48 48 40 48 48 52 48 48 48 13 14
36 15 48 48 48 48 52 52 52 48 40 48 48 48 48 48 48 48 48 48 48 40 48 48 48 48 48 48 13 38
12 15 12 12 12 12 12 12 12 12 12 12 12 12 12 12 12 12 12 12 12 12 12 12 12 12 12 12 12 12
12 15 37 13 13 37 13 37 37 13 13 37 13 13 37 13 13 13 37 13 13 37 13 13 37 13 13 37 13 13