12 12 12 12 12 12 12 12 12 12 12 12 12 12 12 12 12 12 12 12 12 12 12 12 12 12 12 12 12 12 12 12 12 12 12 12 12 12 12 12 12 12 12 12 12 12 12 12 12 12
12 3 1 2 1 0 0 0 3 2 2 1 0 2 3 3 2 1 0 0 40 40 0 1 1 2 2 1 1 0 3 0 0 0 2 0 0 2 2 1 3 2 2 3 3 1 0 40 2 12
12 2 2 2 0 1 0 2 2 2 1 1 2 3 0 2 2 0 2 2 40 40 56 56 4 7 5 56 56 3 0 1 2 0 1 1 0 2 2 2 1 1 2 0 2 1 2 40 3 12
12 2 1 0 56 37 37 37 56 3 1 2 1 1 1 1 2 1 2 2 40 40 38 56 7 5 4 56 36 2 2 0 2 1 0 2 2 1 3 0 1 2 1 0 0 1 0 40 0 12
12 3 1 3 56 56 56 56 56 2 0 1 1 0 1 3 2 1 3 3 40 40 38 56 6 60 7 56 36 1 3 3 2 2 3 1 0 1 1 2 3 1 0 1 3 3 1 40 2 12
12 2 3 3 6 6 5 5 5 3 3 2 0 1 0 3 2 0 1 2 40 40 38 56 4 4 7 56 36 0 1 3 2 0 0 0 2 1 2 1 1 0 3 1 0 1 1 40 1 12
12 1 3 2 5 5 60 7 6 1 3 3 0 1 3 2 3 1 3 3 40 40 56 56 5 6 7 56 56 2 3 3 1 1 0 2 1 3 0 2 2 2 0 3 3 3 2 40 3 12
12 0 0 3 6 5 4 5 4 1 0 3 3 3 0 1 2 1 3 1 40 40 2 0 3 1 0 3 1 1 1 1 1 3 1 3 1 2 0 0 2 1 0 2 1 1 0 40 3 12
12 2 0 1 56 56 56 56 56 3 2 1 2 0 0 1 2 1 3 2 40 40 1 0 1 2 2 0 0 0 2 3 3 3 0 1 0 3 2 2 56 37 37 37 56 0 1 40 3 12
12 3 0 2 56 39 39 39 56 0 3 2 0 1 0 3 3 0 0 3 40 40 2 3 3 0 0 3 0 1 1 0 1 0 1 2 0 0 1 0 56 56 56 56 56 1 1 40 3 12
12 3 0 2 3 1 3 3 3 0 0 2 2 0 0 2 1 1 1 1 40 40 2 0 3 2 0 1 1 2 0 1 1 1 0 2 1 3 3 2 5 4 4 4 4 3 0 40 1 12
12 2 0 1 1 2 3 0 0 1 1 1 0 2 2 1 0 3 2 1 40 40 2 3 3 3 2 3 2 3 1 2 3 3 2 1 3 1 2 3 4 6 60 6 7 1 1 40 1 12
12 0 2 2 0 1 3 1 1 2 1 0 2 2 1 2 3 0 2 0 40 40 1 0 0 1 3 1 1 2 2 0 2 0 1 1 0 1 2 2 6 6 5 6 5 2 2 40 3 12
12 0 0 0 3 2 1 0 1 3 2 1 2 2 3 3 0 1 3 1 40 40 3 2 0 68 67 67 67 67 67 67 67 67 71 2 0 1 3 1 56 56 56 56 56 2 0 40 3 12
12 41 41 41 41 41 41 41 41 41 41 41 41 41 41 41 41 41 41 41 40 40 0 0 68 85 86 84 84 86 87 84 86 86 66 3 3 1 0 1 56 39 39 39 56 2 2 40 1 12
12 3 2 0 1 3 1 1 0 0 2 2 3 0 0 1 2 2 1 0 40 40 2 2 64 84 86 85 87 85 84 87 84 85 66 3 3 2 0 1 0 3 3 3 2 1 3 40 0 12
12 3 1 3 0 2 3 2 3 2 3 2 0 0 2 2 3 0 1 1 40 40 0 2 64 85 86 85 87 86 86 86 84 84 66 0 3 3 2 2 2 3 2 2 1 2 1 40 0 12
12 2 1 1 3 1 0 0 1 3 1 0 3 1 1 0 1 1 0 3 40 40 0 3 64 86 85 84 87 86 86 86 87 87 70 3 0 3 2 1 2 0 1 3 3 3 3 40 1 12
12 3 3 0 2 7 0 4 4 1 0 3 3 6 4 7 2 6 3 0 40 40 3 3 64 84 84 84 85 86 85 87 87 70 3 0 3 0 0 3 2 0 1 3 1 0 2 40 3 12
12 2 1 3 5 1 0 3 3 0 2 0 2 3 1 1 3 1 1 0 40 40 3 1 64 87 86 87 85 85 84 84 66 3 2 3 2 1 2 1 0 0 0 0 3 2 3 40 1 12
12 1 1 1 0 2 2 2 56 37 37 37 56 2 2 3 3 0 0 3 40 40 0 0 64 87 87 86 87 87 84 85 66 1 2 2 2 0 3 3 2 2 0 2 2 0 1 40 2 12
12 0 2 4 2 3 1 1 56 56 56 56 56 2 0 3 6 3 3 1 40 40 1 1 69 65 87 86 65 65 86 86 86 67 67 71 2 2 3 2 3 3 3 0 2 0 0 40 3 12
12 4 2 0 3 2 0 0 5 4 7 7 4 1 3 0 4 1 2 0 40 40 3 0 1 2 69 70 0 1 64 85 84 86 87 84 71 2 1 3 3 2 2 3 0 3 2 40 0 12
12 4 3 4 2 1 0 3 7 4 60 4 5 1 1 3 6 0 2 1 40 40 2 3 2 1 3 1 0 1 64 86 84 85 86 85 66 3 0 1 56 56 5 6 5 56 56 40 2 12
12 2 6 7 1 2 2 0 6 7 7 6 6 3 3 2 4 2 0 1 40 40 0 3 0 2 0 3 2 3 64 84 85 87 87 85 66 2 0 2 38 56 7 7 4 56 36 40 3 12
12 1 1 0 1 2 1 0 56 56 56 56 56 3 1 6 7 2 1 3 40 40 1 3 1 2 0 2 1 2 64 85 86 84 84 84 66 0 2 0 38 56 6 60 7 56 36 40 2 12
12 3 1 4 4 3 1 0 56 39 39 39 56 2 3 2 0 1 0 1 40 40 1 0 6 0 3 1 2 3 64 85 86 84 87 85 66 2 2 0 38 56 6 4 4 56 36 40 2 12
12 0 1 6 7 1 2 0 3 3 1 2 0 2 5 1 0 2 2 0 40 40 1 2 0 1 0 1 3 1 64 86 86 84 85 85 66 1 1 2 56 56 7 5 6 56 56 40 2 12
12 1 3 3 0 1 1 5 1 3 0 3 1 2 6 3 1 0 0 0 40 40 3 1 2 2 3 1 3 1 69 87 86 85 87 86 70 0 3 2 2 2 0 3 2 2 0 40 0 12
12 0 2 4 0 2 0 7 4 1 0 2 3 3 3 0 3 0 0 2 40 40 3 2 0 1 6 2 2 1 3 69 87 85 65 70 1 3 3 0 0 5 6 7 3 1 0 40 1 12
12 0 5 2 2 3 1 3 2 0 2 5 7 6 1 1 0 0 0 1 40 40 1 2 2 2 0 3 3 0 0 1 64 66 3 3 0 1 2 1 5 2 2 2 0 0 0 40 2 12
12 0 5 2 3 1 0 3 1 0 3 1 2 0 2 1 3 2 1 1 40 40 3 1 3 2 0 4 3 0 0 3 69 70 3 1 0 3 2 3 2 2 1 2 1 0 0 40 3 12
12 0 4 7 7 7 2 0 1 5 1 2 6 4 1 3 2 3 2 2 40 40 2 1 2 1 3 2 3 0 3 1 1 7 0 2 1 0 4 7 0 0 0 7 0 0 2 40 1 12
12 0 2 0 2 0 1 0 2 2 1 0 3 0 2 2 3 2 1 3 40 40 0 3 2 0 1 3 0 2 2 1 2 2 3 3 3 0 0 1 3 3 3 3 2 2 0 40 2 12
12 0 2 2 2 2 3 3 2 3 1 3 2 3 1 0 3 1 2 3 40 40 3 0 2 2 3 0 1 1 2 2 3 0 3 1 3 2 1 0 3 1 3 1 1 2 0 40 3 12
12 2 1 0 2 3 2 3 1 0 3 1 1 1 1 1 1 3 1 0 40 40 2 2 1 3 0 0 0 2 3 0 3 1 2 1 3 2 3 2 3 0 3 1 0 3 0 40 0 12
12 41 41 41 41 41 41 41 41 41 41 41 41 41 41 41 41 41 41 41 40 40 41 41 41 41 41 41 41 41 41 41 41 41 41 41 41 41 41 41 41 41 41 41 41 41 41 40 41 12
12 1 2 1 0 3 2 1 2 1 2 0 2 3 1 0 0 1 2 2 40 40 1 3 2 2 0 1 0 1 3 0 1 0 1 1 1 2 2 0 0 2 3 1 2 3 1 40 1 12
12 1 2 3 6 4 3 0 2 6 7 1 0 0 3 1 0 1 1 3 40 40 3 0 2 0 0 3 3 0 0 0 1 0 5 7 1 2 7 6 1 2 0 0 2 1 0 40 3 12
12 0 56 56 7 4 4 56 56 3 1 2 7 3 1 2 2 0 0 2 40 40 3 1 6 1 4 5 6 0 3 0 1 7 2 3 2 0 1 1 1 56 37 37 37 56 1 40 1 12
12 2 38 56 7 5 7 56 36 3 0 3 1 0 2 1 3 2 2 0 40 40 2 3 1 3 0 0 0 5 0 1 1 2 2 2 0 3 7 0 3 56 56 56 56 56 0 40 3 12
12 2 38 56 6 60 5 56 36 3 3 1 6 1 2 2 1 2 3 1 40 40 2 56 37 37 37 56 0 5 2 3 1 3 2 0 1 1 5 1 1 7 6 4 5 7 0 40 0 12
12 2 38 56 7 5 4 56 36 2 1 0 5 0 1 5 5 1 0 1 40 40 1 56 56 56 56 56 3 0 2 0 1 1 1 0 0 1 6 0 2 7 4 60 6 7 0 40 2 12
12 0 56 56 7 6 4 56 56 3 0 1 5 3 0 2 2 0 3 3 40 40 0 4 4 7 6 4 3 2 2 0 2 0 0 7 0 3 1 2 2 7 7 5 6 7 2 40 3 12
12 0 3 2 1 1 0 2 3 0 1 0 4 1 1 1 2 2 1 1 40 40 0 7 5 60 4 6 3 3 0 2 3 3 3 1 3 4 1 2 1 56 56 56 56 56 1 40 2 12
12 0 2 1 6 5 6 3 7 0 5 1 5 2 1 2 3 1 2 0 40 40 3 6 4 6 5 7 0 2 3 3 3 1 0 3 1 5 7 1 0 56 39 39 39 56 3 40 0 12
12 0 0 1 6 2 0 3 0 2 3 2 1 3 1 3 1 4 5 0 40 40 2 56 56 56 56 56 0 0 0 4 2 3 3 0 3 5 2 0 3 0 3 1 3 2 1 40 3 12
12 3 1 4 3 1 1 2 3 3 5 7 1 3 1 2 0 0 3 0 40 40 3 56 39 39 39 56 2 1 2 0 1 1 1 3 2 2 2 3 2 3 0 1 0 3 2 40 3 12
12 3 1 3 0 6 4 7 0 0 3 3 2 1 1 0 0 3 1 3 40 40 1 0 1 1 3 2 3 3 0 0 1 1 2 0 0 0 2 2 3 0 1 3 2 1 1 40 2 12
12 12 12 12 12 12 12 12 12 12 12 12 12 12 12 12 12 12 12 12 12 12 12 12 12 12 12 12 12 12 12 12 12 12 12 12 12 12 12 12 12 12 12 12 12 12 12 12 12 12