56 56 56 56 56 39 39 39 39 56 56 39 39 39 39 56 56 39 39 39 39 56 56 39 39 39 39 56 56 39 39 39 39 56 56 39 39 39 39 56 56 39 39 39 39 56 56 56 56 56
56 56 56 56 56 0 2 2 0 56 56 2 2 2 2 56 56 0 0 0 0 56 56 0 0 2 2 56 56 2 2 0 0 56 56 0 2 0 0 56 56 0 0 2 0 56 56 56 56 56
56 56 56 56 56 2 0 0 0 56 56 0 0 0 0 56 56 2 2 0 0 56 56 0 0 0 2 56 56 0 0 0 0 56 56 0 0 0 0 56 56 0 0 0 0 56 56 56 56 56
56 56 56 56 56 0 0 0 0 56 56 0 0 0 0 56 56 0 0 0 0 56 56 0 0 0 0 56 56 0 0 0 0 56 56 0 0 0 0 56 56 0 0 0 0 56 56 56 56 56
56 56 56 56 56 56 0 0 56 56 56 56 0 0 56 56 56 56 0 0 56 56 56 56 0 0 56 56 56 56 0 0 56 56 56 56 0 0 56 56 56 56 0 0 56 56 56 56 56 56
36 0 0 0 56 72 81 82 72 74 74 72 81 82 72 80 0 0 0 0 0 0 0 0 0 0 0 0 0 0 0 0 0 0 83 72 81 82 72 72 74 72 81 82 72 56 0 0 0 38
36 0 0 0 0 83 72 72 73 73 75 75 72 72 80 0 0 0 0 0 0 0 0 0 0 0 0 0 0 0 0 0 0 0 0 83 72 72 72 73 74 74 72 72 80 0 0 0 2 38
36 0 0 0 0 82 72 73 73 72 74 72 72 80 0 0 0 0 0 0 0 0 0 0 0 0 0 0 1 0 0 0 0 0 0 0 83 72 72 73 74 72 74 72 81 0 0 3 2 38
36 0 0 0 56 72 73 73 72 72 74 72 80 2 2 0 0 16 0 0 0 0 0 1 0 0 1 0 0 0 0 0 16 0 0 0 0 83 72 74 73 73 74 72 72 56 0 0 2 38
56 56 56 56 56 72 72 73 73 72 72 80 0 2 0 0 0 16 0 0 0 0 1 1 1 1 1 0 0 0 0 0 16 0 0 0 0 0 83 74 74 74 72 74 72 56 56 56 56 56
56 56 56 56 56 72 74 74 74 72 80 0 0 0 0 0 0 16 0 0 0 2 0 1 1 1 0 2 0 0 0 0 16 0 0 0 0 0 0 83 72 72 74 72 74 56 56 56 56 56
36 0 0 0 56 72 74 72 72 80 0 0 2 0 2 0 0 16 0 0 0 2 1 0 0 2 2 0 0 0 0 0 16 0 0 0 0 0 0 0 83 72 72 72 72 56 0 3 0 38
36 0 0 0 0 83 74 74 80 0 0 2 2 2 2 2 0 16 0 0 1 0 0 1 0 2 1 0 0 0 0 0 16 0 0 0 0 0 0 0 0 83 72 72 80 0 0 0 2 38
36 0 0 0 0 82 72 80 0 0 0 0 0 0 2 0 0 16 0 0 0 2 0 0 0 0 1 0 0 0 0 0 16 0 0 0 0 0 0 0 0 0 83 72 81 0 0 0 2 38
36 0 0 0 56 72 80 0 0 0 2 0 0 0 0 0 0 0 0 0 0 2 0 0 0 0 0 0 0 0 0 0 0 0 0 0 0 0 0 0 0 0 0 83 72 56 0 3 2 38
56 56 56 56 56 80 0 0 0 0 2 2 0 0 0 0 0 0 0 0 0 2 0 2 2 0 0 0 0 0 0 0 0 0 0 0 0 0 0 0 0 0 0 0 83 56 56 56 56 56
56 56 56 56 56 0 0 0 0 0 0 0 0 0 0 0 0 0 0 0 0 0 0 0 0 1 1 1 1 1 0 0 0 0 0 0 0 0 0 0 0 0 0 0 0 56 56 56 56 56
36 0 0 0 56 0 0 0 16 16 16 16 16 16 0 0 0 68 67 67 67 67 67 67 67 67 67 67 67 67 67 67 71 0 0 0 16 16 16 16 16 16 0 0 0 56 0 0 0 38
36 0 0 0 0 0 0 0 0 0 0 0 0 0 0 0 0 64 84 84 84 84 84 84 84 84 84 84 84 84 84 84 66 0 0 0 0 0 0 0 0 0 0 0 0 0 0 3 0 38
36 0 0 0 0 0 0 0 0 0 0 0 0 0 0 1 1 64 84 84 84 84 84 84 84 84 84 84 84 84 84 84 66 0 0 0 0 0 0 0 0 0 3 0 0 0 0 0 2 38
36 0 0 0 56 0 0 0 0 0 0 0 0 0 0 1 0 64 84 84 84 84 84 84 84 84 84 84 84 84 84 84 66 0 0 0 0 2 3 0 0 0 0 0 0 56 0 0 2 38
56 56 56 56 56 0 0 0 2 1 1 1 1 1 0 0 0 64 84 84 84 84 84 84 84 84 84 84 84 84 84 84 66 0 0 1 0 2 1 0 0 0 0 0 0 56 56 56 56 56
56 56 56 56 56 0 1 2 0 0 1 0 1 1 0 0 0 64 84 84 84 84 84 65 65 65 65 84 84 84 84 84 66 0 0 0 0 2 0 1 1 0 1 0 0 56 56 56 56 56
36 0 0 0 56 0 0 1 0 1 0 0 0 1 0 0 0 64 84 84 84 84 66 4 4 4 4 64 84 84 84 84 66 1 0 0 2 0 1 0 0 0 1 0 0 56 0 0 2 38
36 0 0 0 0 0 0 1 0 0 1 0 0 0 0 0 1 64 84 84 84 84 66 4 4 4 4 64 84 84 84 84 66 1 0 0 2 0 1 0 0 1 0 0 0 0 0 0 0 38
36 0 0 0 0 0 0 1 0 1 0 0 2 1 0 0 1 64 84 84 84 84 66 4 4 4 4 64 84 84 84 84 66 1 1 2 2 1 0 0 0 1 0 0 0 0 0 0 2 38
36 0 0 0 56 0 0 0 0 0 0 1 2 0 0 0 0 64 84 84 84 84 66 4 4 4 4 64 84 84 84 84 66 1 1 2 2 0 0 0 0 0 0 0 0 56 0 3 2 38
56 56 56 56 56 0 0 1 0 0 0 0 2 0 0 0 0 64 84 84 84 84 84 67 67 67 67 84 84 84 84 84 66 1 0 0 0 0 3 0 0 1 0 0 0 56 56 56 56 56
56 56 56 56 56 0 1 1 0 0 0 1 0 0 0 0 1 64 84 84 84 84 84 84 84 84 84 84 84 84 84 84 66 0 1 0 0 1 3 0 0 0 0 0 0 56 56 56 56 56
36 0 0 0 56 0 1 0 0 0 1 0 0 0 0 0 1 64 84 84 84 84 84 84 84 84 84 84 84 84 84 84 66 0 1 0 3 1 0 0 3 0 0 1 0 56 0 0 2 38
36 0 0 0 0 0 1 0 0 1 0 1 0 0 0 0 0 64 84 84 84 84 84 84 84 84 84 84 84 84 84 84 66 0 0 0 0 0 0 1 3 0 1 0 0 0 0 3 0 38
36 0 0 0 0 0 0 0 0 0 0 0 0 0 0 0 1 64 84 84 84 84 84 84 84 84 84 84 84 84 84 84 66 0 1 0 0 3 0 0 0 0 0 0 0 0 0 0 0 38
36 0 0 0 56 0 0 0 16 16 16 16 16 16 0 0 0 69 65 65 65 65 65 65 65 65 65 65 65 65 65 65 70 0 1 0 16 16 16 16 16 16 0 0 0 56 0 3 0 38
56 56 56 56 56 0 0 0 0 0 0 0 0 0 0 0 0 0 0 0 1 0 1 1 1 1 1 1 1 0 0 0 0 0 0 0 0 0 0 0 0 0 0 0 0 56 56 56 56 56
56 56 56 56 56 81 0 0 0 0 0 0 0 0 0 0 0 0 0 1 0 0 0 0 0 0 0 0 0 0 0 0 0 0 0 1 0 0 1 0 0 0 0 0 82 56 56 56 56 56
36 0 0 0 56 72 81 0 0 1 1 1 1 0 1 0 0 0 0 0 0 1 1 1 1 0 1 0 0 0 0 0 0 0 0 0 0 0 1 0 2 0 0 82 72 56 0 3 2 38
36 0 0 0 0 83 72 81 0 1 0 0 1 1 1 0 0 16 0 0 0 0 0 0 0 0 0 0 0 0 0 0 16 0 0 0 0 2 2 0 0 0 82 72 80 0 0 3 2 38
36 0 0 0 0 82 72 72 81 0 0 0 0 0 1 0 0 16 0 1 1 0 0 1 0 0 0 0 1 0 0 0 16 0 0 1 0 2 0 2 0 82 75 72 81 0 0 0 0 38
36 0 0 0 56 72 74 74 72 81 0 0 0 0 0 0 0 16 0 0 0 1 1 1 1 0 0 0 1 0 0 0 16 0 0 1 0 2 0 0 82 72 75 74 72 56 0 3 2 38
56 56 56 56 56 72 74 72 74 72 81 0 0 1 0 0 0 16 0 0 1 0 0 0 0 0 0 0 0 1 0 0 16 0 1 0 0 0 0 82 72 75 74 72 75 56 56 56 56 56
56 56 56 56 56 72 74 74 75 72 72 81 0 1 0 0 0 16 0 0 1 0 1 0 1 0 1 1 1 0 0 0 16 0 0 0 0 0 82 72 74 73 74 74 72 56 56 56 56 56
36 0 0 0 56 72 74 75 72 75 75 72 81 0 0 0 0 16 0 0 0 0 0 0 0 0 0 0 0 0 0 0 16 0 0 0 0 82 74 74 74 73 74 72 75 56 0 0 0 38
36 0 0 0 0 83 72 72 72 74 75 75 72 81 0 0 0 0 0 0 0 0 0 0 0 0 0 0 0 0 0 0 0 0 0 0 82 75 75 75 73 74 72 72 80 0 0 0 0 38
36 0 0 0 0 82 72 72 75 72 75 75 75 72 81 0 0 0 0 0 0 0 0 0 0 0 0 0 0 0 0 0 0 0 0 82 72 75 75 74 74 72 72 72 81 0 0 0 0 38
36 0 0 0 56 72 80 83 72 75 72 72 80 83 72 81 0 0 0 0 0 0 0 0 0 0 0 0 0 0 0 0 0 0 82 72 80 83 72 74 72 72 80 83 72 56 0 0 0 38
56 56 56 56 56 56 0 0 56 56 56 56 0 0 56 56 56 56 0 0 56 56 56 56 0 0 56 56 56 56 0 0 56 56 56 56 0 0 56 56 56 56 0 0 56 56 56 56 56 56
56 56 56 56 56 0 0 0 0 56 56 0 0 0 0 56 56 0 0 0 0 56 56 0 0 0 0 56 56 0 0 0 0 56 56 0 0 0 0 56 56 0 0 0 0 56 56 56 56 56
56 56 56 56 56 0 0 0 0 56 56 0 0 0 0 56 56 0 0 0 0 56 56 0 0 0 0 56 56 0 0 0 0 56 56 0 0 0 0 56 56 0 0 0 0 56 56 56 56 56
56 56 56 56 56 0 0 0 0 56 56 0 0 0 0 56 56 0 0 0 0 56 56 0 0 0 0 56 56 0 0 0 0 56 56 0 0 0 0 56 56 0 0 0 0 56 56 56 56 56
56 56 56 56 56 37 37 37 37 56 56 37 37 37 37 56 56 37 37 37 37 56 56 37 37 37 37 56 56 37 37 37 37 56 56 37 37 37 37 56 56 37 37 37 37 56 56 56 56 56